royalty: royalties 
covered: covered 
asured: asured 
besides: besides 
spotify: spotify 
hit: hit hits 
bieber: bieber 
elcid: elcid 
lend: lend 
wheatley: wheatley 
catherine: catherine 
spoon: spoon 
jeanne: jeanne 
misty: misty 
word: word words 
squirt: squirt 
ethereal: ethereal 
graceland: graceland 
boylan: boylan 
war: war wars 
ai: aises ais 
charles: charles 
nashville: nashville 
mansion: mansion mansions 
recurring: recurring 
knowing: knowing 
offend: offend 
southside: southside 
dancefloor: dancefloor 
gore: gore 
important: important 
fill: fill 
perceived: perceived 
buck: bucks 
malone: malone 
husband: husbands husband 
nonsense: nonsense 
sic: sic 
expanded: expanded 
koen: koen 
feature: feature features 
berkowitz: berkowitz 
dear: dear 
stoney: stoney 
university: university 
jedwill: jedwill 
daytime: daytime 
zyx: zyx 
genius: genius 
rotten: rotten 
puesto: puesto 
confirmation: confirmation 
los: los 
checking: checking 
ramon: ramon 
birthday: birthday 
dubbed: dubbed 
den: den 
cannonball: cannonball 
dedicated: dedicated 
quite: quite 
alludes: alludes 
bassy: bassy 
graceffa: graceffa 
owen: owens owen 
usually: usually 
db: db 
freckle: freckles 
burnup: burnup 
sek: sek 
shield: shield shields 
girly: girly 
puente: puente 
skip: skip 
swear: swear 
mayday: mayday 
proposal: proposal 
glyn: glyn 
bone: bone bones 
avenue: avenue 
feb: feb 
impression: impressions 
timeless: timeless 
live: live 
polite: polite 
guitarra: guitarra 
tennesee: tennesee 
shlosser: shlosser 
remixed: remixed 
motherfucker: motherfuckers motherfucker 
songwritery: songwritery 
chicken: chicken 
waugh: waugh 
sw: sw 
gone: gone 
ride: ride 
jon: jon 
year: years year 
serum: sera 
mickelson: mickelson 
campfire: campfire 
tramp: tramp 
fakir: fakir 
cullum: cullum 
deutsche: deutsche 
miscommunications: miscommunications 
sue: sue 
entrar: entrar 
taken: taken 
advance: advance 
denver: denver 
fact: fact facts 
phantom: phantom 
frontrunner: frontrunner 
bout: bout 
watanabe: watanabe 
beautiful: beautiful 
filmmaker: filmmaker 
havran: havran 
stiggy: stiggy 
risk: risk 
oww: oww 
harmonica: harmonica 
midnight: midnights midnight 
miner: miners miner 
platter: platters 
shaka: shaka 
serafini: serafini 
eat: eat 
jesus: jesus 
campa: campa 
eh: eh 
oholibamah: oholibamah 
shoring: shoring 
edge: edge 
donut: donuts 
penny: penny 
stayed: stayed 
rockstar: rockstar 
jail: jail 
juliet: juliet 
anthony: anthony 
sainthood: sainthood 
swampers: swampers 
ginny: ginny 
intenci: intenci 
paradox: paradox 
medium: medium media 
kikdoe: kikdoe 
sashay: sashay 
plane: plane planes 
train: train 
kind: kinds kind 
ruin: ruin 
vomit: vomit 
figure: figures figure 
senator: senators 
playing: playing 
mayer: mayer 
possibly: possibly 
hike: hike 
lynn: lynn 
road: roads road 
ranta: ranta 
intoxicating: intoxicating 
hutchcroft: hutchcroft 
cuarentena: cuarentena 
swearin: swearin 
hutson: hutson 
youth: youth 
meyer: meyer 
parr: parr 
smug: smug 
straight: straight 
strong: strong 
plan: plan plans 
discussed: discussed 
water: waters water 
gandhi: gandhi 
hungarian: hungarian 
city: city 
promote: promote 
brine: brine 
hush: hush 
struggle: struggle struggles 
physical: physical 
isle: isle 
hate: hate hates 
byrd: byrds 
angst: angst 
bainz: bainz 
alt: alt 
court: court 
shrink: shrink 
sica: sica 
orchestra: orchestra 
amuse: amuse 
homeroom: homeroom 
matthew: matthews matthew 
bala: bala 
playa: playa 
dale: dale 
summer: summers summer 
list: list lists 
richard: richard 
polskie: polskie 
rifle: rifle 
exceptionally: exceptionally 
usual: usual 
movie: movie movies 
grosjean: grosjean 
liner: liner 
rattle: rattle 
moral: moral 
grave: grave 
deluxe: deluxe 
make: makes make 
lambert: lambert 
horn: horns horn 
whilst: whilst 
montrose: montrose 
pipeline: pipeline 
behalf: behalf 
kaplan: kaplan 
olson: olson 
presence: presence 
except: except 
fully: fully 
kesel: kesel 
ought: ought 
theme: themes theme 
contemporary: contemporary 
rainin: rainin 
note: notes note 
adriano: adriano 
th: th 
peterson: peterson 
pocos: pocos 
wreck: wreck 
hunger: hunger 
nick: nick 
jonxgb: jonxgb 
industry: industry 
latin: latin 
invitation: invitations 
ago: ago 
modern: modern 
spin: spin 
punk: punk 
charted: charted 
reflecting: reflecting 
accompanied: accompanied 
whoa: whoa 
joke: jokes joke 
bottle: bottle bottles 
hole: hole 
oriented: oriented 
guitarist: guitarist 
aye: aye 
expressed: expressed 
nearest: nearest 
romeo: romeo 
freedom: freedom 
instalok: instalok 
mister: mister 
radiated: radiated 
biral: biral 
ainhoa: ainhoa 
message: message 
arena: arena 
grundman: grundman 
fence: fences fence 
indicator: indicator 
steal: steal 
caus: caus 
glenn: glenn 
dando: dando 
connor: connor 
tied: tied 
fled: fled 
parallel: parallels parallel 
missile: missile 
talkin: talkin 
polit: polit 
tour: tours tour 
famous: famous 
shine: shine 
initial: initial 
vaccine: vaccines 
glass: glass glasses 
pokey: pokey 
technique: technique 
adjustment: adjustment 
highest: highest 
hornpipe: hornpipe 
significant: significant 
smosh: smosh 
mend: mend 
generator: generator 
jake: jake 
baj: baj 
electro: electro 
olsson: olsson 
dragonas: dragonas 
drinking: drinking 
skin: skin 
te: te tes 
thicker: thicker 
outskirt: outskirts 
madilyn: madilyn 
doraville: doraville 
lagg: lagg 
lester: lester 
jimmie: jimmie 
heider: heider 
soon: soon 
ulmer: ulmer 
inmate: inmates 
india: india 
lion: lion 
indulgence: indulgence 
drought: drought 
pe: pe 
update: update 
jailhouse: jailhouse 
ghenea: ghenea 
remained: remained 
reichenbach: reichenbach 
grammys: grammys 
alltoowelltenminuteversion: alltoowelltenminuteversion 
anthemic: anthemic 
coates: coates 
bump: bumps 
grope: grope 
moment: moment moments 
sample: samples sample 
traxx: traxx 
partido: partido 
trident: trident 
stole: stole 
ndote: ndote 
vicevversa: vicevversa 
allan: allan 
led: led 
tambourine: tambourine 
accordion: accordion 
folk: folk folks 
younger: younger 
moonshine: moonshine 
snooze: snooze 
ever: ever 
kya: kya 
evermore: evermore 
ended: ended 
top: top topses 
shortcut: shortcut 
gangsta: gangsta 
hug: hug 
answered: answered 
aquarium: aquarium 
rainbow: rainbow 
idol: idols idol 
tough: tough 
fame: fame 
driveway: driveway driveways 
story: story stories 
yuma: yuma 
bra: bras 
internal: internal 
blackbear: blackbear 
misali: misali 
brother: brother brothers 
herbie: herbie 
adriansings: adriansings 
lot: lot 
overall: overalls 
sarah: sarah 
consistent: consistent 
traducci: traducci 
thematically: thematically 
kravitz: kravitz 
frozen: frozen 
taylor: taylor 
club: club 
knowin: knowin 
violin: violins violin 
jayne: jayne 
pat: pat 
meanwhile: meanwhile 
cigarette: cigarettes cigarette 
gratitude: gratitude 
saul: saul 
bind: binds bind 
pretend: pretend pretends 
coordinator: coordinator 
ilbert: ilbert 
licensor: licensor 
alongside: alongside 
uke: uke 
ayy: ayy 
dreaming: dreaming 
close: close closes 
mcppl: mcppl 
deal: deals deal 
softly: softly 
signing: signing 
juice: juice 
transmisi: transmisi 
lifestyle: lifestyle 
herd: herd 
view: view views 
idaho: idaho 
prayer: prayer prayers 
win: win wins 
colbreakz: colbreakz 
session: sessions session 
healey: healey 
packed: packed 
hendricks: hendricks 
fianc: fianc 
blond: blond 
vogue: vogue 
roc: roc 
thief: thieves thief 
shard: shards 
alike: alike 
virgil: virgil 
government: government 
robinson: robinson 
rocket: rocket 
bondio: bondio 
weakness: weakness 
comparison: comparisons 
danna: danna 
look: looks look 
duke: duke 
taste: taste 
lisa: lisa 
flourish: flourishes 
abigail: abigail 
logan: logan 
muller: muller 
honky: honky 
deer: deer 
promotional: promotional 
sunshine: sunshine 
crossey: crossey 
beverly: beverly 
wanting: wanting 
rhetty: rhetty 
noble: noble 
explicitly: explicitly 
saldr: saldr 
seeing: seeing 
beatles: beatles 
appear: appear 
ar: ar 
lynyrd: lynyrd 
mexican: mexican 
lead: leads lead 
skirt: skirts 
nyc: nyc 
pursue: pursue 
volver: volver 
section: section 
liz: liz 
lujan: lujan 
cinnamon: cinnamon 
maintain: maintain 
engine: engine 
impending: impending 
fft: fft 
later: later 
manufacturer: manufacturer 
prevod: prevod 
proof: proof 
puede: puede 
wetton: wetton 
nuevo: nuevo 
friend: friend friends 
marie: marie 
charlie: charlie 
supply: supplies 
strategized: strategized 
due: due 
defensive: defensive 
charley: charley 
fist: fist 
posting: posting 
friel: friel 
debuting: debuting 
spot: spots spot 
corry: corry 
jibjab: jibjab 
poopdiepie: poopdiepie 
based: based 
intensely: intensely 
took: took 
fisherman: fisherman fishermen 
gimmicky: gimmicky 
drive: drive drives 
ugh: ugh 
killed: killed 
elvira: elvira 
master: master 
flower: flower flowers 
odyssey: odyssey 
fla: fla 
narration: narration 
yo: yo 
closer: closer 
anniversary: anniversary 
mcgill: mcgill 
fitzgerald: fitzgerald 
mile: mile miles 
dj: dj 
sink: sink sinks 
ganjo: ganjo 
podcast: podcast 
leahy: leahy 
cohen: cohen 
hor: hor 
pumpin: pumpin 
precursor: precursor 
hallelujah: hallelujah 
sevilla: sevilla 
ups: ups 
grinning: grinning 
downtown: downtown 
created: created 
awake: awake 
guitar: guitar guitars 
elli: ellis 
exposition: exposition 
joan: joan 
maid: maid 
alanis: alanis 
rewarding: rewarding 
continuous: continuous 
mariner: mariners 
color: colors color 
sterling: sterling 
already: already 
iamtidus: iamtidus 
mtv: mtv 
deehousemf: deehousemf 
instrumentals: instrumentals 
shot: shot shots 
tossing: tossing 
ferry: ferry 
express: expresses express 
ericsson: ericsson 
grant: grant 
roan: roan 
younce: younce 
r: r 
borchetta: borchetta 
tale: tales tale 
third: third 
outraged: outraged 
beefsteak: beefsteaks 
davie: davie 
kimber: kimber 
magyar: magyar 
hamilton: hamilton 
souped: souped 
morton: morton 
acing: acing 
digital: digital 
grimmie: grimmie 
christmas: christmas 
sharp: sharp 
traduceri: traduceri 
foaming: foaming 
growin: growin 
reminiscing: reminiscing 
stationed: stationed 
rafael: rafael 
arash: arash 
cardiac: cardiac 
santa: santa 
crown: crown 
hum: hums 
girl: girls girl 
fennec: fennec 
raining: raining 
mcguinness: mcguinness 
sapphic: sapphic 
test: tests test 
rivas: rivas 
pick: pick picks 
child: child children 
feel: feels feel 
cossom: cossom 
atticus: atticus 
occasion: occasions occasion 
collide: collide 
marenmorris: marenmorris 
fault: fault 
pushed: pushed 
arranged: arranged 
dumplin: dumplin 
shady: shady 
infinity: infinity 
di: di 
stripped: stripped 
yellow: yellow 
fitting: fitting 
john: johns john 
pissed: pissed 
last: last lasts 
contacted: contacted 
played: played 
sharing: sharing 
closet: closets closet 
pleasin: pleasin 
matson: matson 
arrow: arrow 
gut: gut 
wharf: wharf 
official: officials official 
rzr: rzr 
horrorcore: horrorcore 
amanecer: amanecer 
promotion: promotion 
caught: caught 
payyy: payyy 
assistant: assistant 
stand: stand stands 
amazin: amazin 
rob: rob 
delicata: delicata 
hardcore: hardcore 
winnin: winnin 
fergie: fergie 
oven: oven 
hoax: hoax 
australia: australia 
taomi: taomi 
fate: fate 
hardwood: hardwood 
justify: justify 
shadow: shadows 
maverikk: maverikk 
sonic: sonic 
rom: rom 
scru: scru 
canadian: canadian canadians 
appropriately: appropriately 
woman: woman women 
plowman: plowmen 
transgression: transgressions 
chappell: chappell 
perspective: perspectives perspective 
vaj: vaj 
mp: mp 
b: b bs 
locking: locking 
scar: scars scar 
open: open 
teen: teen teens 
losing: losing 
realizing: realizing 
patch: patch patches 
hallmark: hallmarks 
boogie: boogie 
reckless: reckless 
awkward: awkward 
dif: dif 
knowledge: knowledge 
area: areas area 
fortunately: fortunately 
sloas: sloas 
raging: raging 
wasted: wasted 
entertainer: entertainers 
pumping: pumping 
herb: herb 
si: si 
flawless: flawless 
jelly: jelly 
abstract: abstract 
joker: joker 
picture: pictures picture 
indigo: indigo 
gentleness: gentleness 
dazzling: dazzling 
whatsoever: whatsoever 
dahlin: dahlin 
gala: gala 
fernandes: fernandes 
goat: goats 
candle: candles candle 
tee: tee 
sold: sold 
management: management 
induced: induced 
frill: frills 
abandoned: abandoned 
satisfied: satisfied 
appreciate: appreciate 
daring: daring 
stern: stern 
saying: saying 
nowadays: nowadays 
duomo: duomo 
polynesia: polynesia 
epiphany: epiphany 
bluegrass: bluegrass 
start: starts start 
regarded: regarded 
hour: hour hours 
reflection: reflections reflection 
daniela: daniela 
liam: liam 
wicked: wicked 
sleepwalking: sleepwalking 
farm: farms farm 
mature: mature 
northridge: northridge 
tape: tape 
pedrinho: pedrinho 
sahyoun: sahyoun 
porter: porter 
arteta: arteta 
trash: trash 
ango: ango 
sherman: sherman 
response: response 
dolla: dolla 
southland: southland 
nordlund: nordlund 
carol: carol 
rubin: rubin 
collaborator: collaborators collaborator 
jan: jan 
aspect: aspect 
blitzen: blitzen 
closed: closed 
anxiety: anxiety 
um: um 
bey: bey 
qu: qu 
al: al 
xv: xv 
musically: musically 
adem: adem 
reminiscent: reminiscent 
ii: ii 
creeping: creeping 
counter: counter 
vince: vince 
edm: edm 
iii: iii 
kosiak: kosiak 
became: became 
state: state states 
silence: silence 
polydor: polydor 
peyton: peyton 
acodem: acodem 
willis: willis 
blackwood: blackwood 
signal: signal 
able: able 
spring: springs spring 
ambition: ambition 
santo: santo 
bass: bass 
hydracoque: hydracoque 
dirty: dirty 
storyline: storyline 
mama: mama 
uptempo: uptempo 
alvord: alvord 
peace: peace 
norton: norton 
peach: peach peaches 
textually: textually 
puzzle: puzzles 
bmg: bmg 
footstep: footsteps 
ligon: ligon 
byers: byers 
cowboy: cowboys cowboy 
donne: donne 
singer: singers singer 
gloria: gloria 
decide: decide 
braid: braids 
removebeforeflight: removebeforeflight 
ken: ken 
upstairs: upstairs 
quality: quality 
cant: cant 
lineman: lineman 
van: van 
station: station 
strawberry: strawberry 
scoot: scoot 
tattoo: tattoo tattoos 
traffic: traffic 
mmm: mmm 
gasolina: gasolina 
alert: alert 
boot: boot boots 
bartender: bartender 
retrospect: retrospect 
grasp: grasp 
arch: arch 
vacation: vacation 
barry: barry 
erban: erban 
imase: imase 
desk: desk desks 
williams: williams 
driven: driven 
fabric: fabric 
cleared: cleared 
biding: biding 
gordon: gordon 
vault: vault 
attended: attended 
feedback: feedback 
quarterback: quarterbacks 
impress: impress 
chamberlain: chamberlain 
prisoner: prisoner prisoners 
editing: editing 
nle: nle 
sixth: sixth 
expectation: expectations 
rio: rio 
chirot: chirot 
stop: stops stop 
ybn: ybn 
lesson: lesson lessons 
gravel: gravel 
chenoweth: chenoweth 
finesse: finesse 
mcgraw: mcgraw 
toil: toil 
abby: abby 
weeps: weeps 
creciendo: creciendo 
sunrise: sunrise 
neeko: neeko 
sarcastically: sarcastically 
yesterday: yesterday 
true: true 
vocalist: vocalist vocalists 
base: base 
manuel: manuel 
ryuuseigun: ryuuseigun 
easter: easter 
satirically: satirically 
caetano: caetano 
amy: amy 
bamos: bamos 
appreciation: appreciation 
chen: chen 
named: named 
exudes: exudes 
explorer: explorer 
climbin: climbin 
take: takes take 
crowded: crowded 
growl: growl 
forum: forum 
halsey: halsey 
sudden: sudden 
lingering: lingering 
kuil: kuil 
rosa: rosa 
filmed: filmed 
entertain: entertain 
draco: draco 
carry: carry 
bored: bored 
niche: niche 
libs: libs 
forward: forward 
available: available 
feat: feat 
enchanted: enchanted 
mystery: mystery 
taking: taking 
doomed: doomed 
h: h 
haystack: haystack 
songview: songview 
cody: cody 
grandfather: grandfather 
torturous: torturous 
beyond: beyond 
meet: meets meet 
german: german 
campaignin: campaignin 
dance: dances dance 
difficult: difficult 
dominic: dominic 
bolooki: bolooki 
deborah: deborah 
jean: jean jeans 
western: western 
armand: armand 
past: past 
weep: weep 
timber: timber 
se: se 
lawd: lawd 
month: months month 
rural: rural 
sentou: sentou 
violent: violent 
clever: clever 
recanted: recanted 
leading: leading 
announcement: announcement 
stan: stan 
replied: replied 
emilie: emilie 
dwight: dwight 
gal: gal 
dragon: dragons dragon 
lately: lately 
mendelson: mendelson 
correlating: correlating 
back: back 
held: held 
rye: rye 
sky: sky skies 
nue: nue 
muchos: muchos 
turn: turn turns 
scupper: scuppers 
shall: shall 
receipt: receipt 
prepare: prepare 
neo: neo 
autobiography: autobiography 
lucca: lucca 
tiffany: tiffany 
cut: cut cuts 
cowgirl: cowgirls 
recently: recently 
gunfighter: gunfighter 
son: son sons 
listening: listening 
coliseum: coliseum 
phish: phish 
jumpin: jumpin 
rack: rack 
record: record records 
noun: noun 
acuerdo: acuerdo 
facing: facing 
grim: grim 
bill: bills bill 
bernie: bernie 
fateful: fateful 
menu: menu 
xxxtentacion: xxxtentacion 
bible: bibles bible 
piano: piano 
rawinthevoid: rawinthevoid 
credited: credited 
say: say says 
hagen: hagen 
skateboard: skateboard 
attempt: attempt 
fever: fever 
ferrari: ferrari 
schramm: schramm 
highway: highway 
andy: andy 
remastering: remastering 
project: projects project 
relationship: relationships relationship 
cited: cited 
like: likes like 
blackmon: blackmon 
production: productions production 
jessie: jessie 
lungo: lungo 
dollar: dollar dollars 
perry: perry 
asada: asada 
corenflos: corenflos 
pressed: pressed 
danthology: danthology 
commercially: commercially 
scrolling: scrolling 
boy: boys boy 
hickory: hickory 
awareness: awareness 
film: films film 
matt: matt 
angel: angel angels 
sendin: sendin 
forgets: forgets 
quinnell: quinnell 
flowery: flowery 
marriage: marriage marriages 
introduced: introduced 
mob: mob 
predictive: predictive 
kaze: kaze 
mad: mad 
tengo: tengo 
stove: stove 
preparation: preparation 
minded: minded 
uncredited: uncredited 
feibelman: feibelman 
rawdon: rawdon 
sweetheart: sweetheart 
blonde: blonde blondes 
ry: ry 
also: also 
chase: chase 
noting: noting 
kane: kane 
askin: askin 
recorded: recorded 
chasing: chasing 
wield: wield 
tiny: tiny 
forest: forest 
jozzy: jozzy 
hoge: hoge 
kaya: kaya 
elisa: elisa 
xtc: xtc 
twain: twain 
twenty: twenty 
banjo: banjo 
k: k 
bomb: bomb 
boundary: boundaries 
sto: sto 
bag: bags bag 
treated: treated 
levin: levin 
howard: howard 
olympic: olympic 
joderlo: joderlo 
recent: recent 
dreamt: dreamt 
liberto: liberto 
predictably: predictably 
swearing: swearing 
wallace: wallace 
liv: liv 
isosine: isosine 
award: award awards 
whole: whole 
parrish: parrish 
depends: depends 
operaci: operaci 
mysterious: mysterious 
langley: langley 
tim: tim 
knickerbocker: knickerbocker 
fernandez: fernandez 
insincerity: insincerity 
needed: needed 
fellow: fellow 
rihanna: rihanna 
bernal: bernal 
ebc: ebc 
mornin: mornin 
leaked: leaked 
loosen: loosen 
parent: parents 
riaa: riaa 
bentley: bentley 
demon: demons 
wilkinson: wilkinson 
among: among 
born: born 
ridin: ridin 
sale: sales sale 
shoegaze: shoegaze 
someday: someday 
blacktop: blacktop 
hildegard: hildegard 
satellite: satellite 
premiere: premiere 
bud: bud 
clothes: clothes 
yet: yet 
rossington: rossington 
rag: rags 
ladose: ladose 
brook: brooks 
lost: lost 
professional: professional 
wynter: wynter 
understand: understand 
psychedelia: psychedelia 
nelson: nelson 
storm: storm 
homies: homies 
flowed: flowed 
brain: brain 
enchanting: enchanting 
uma: uma 
mychael: mychael 
fonda: fonda 
refrain: refrain 
bein: bein 
absurd: absurd 
previously: previously 
soul: souls soul 
bando: bando 
std: stds 
meandering: meandering 
gladwell: gladwell 
timbaland: timbaland 
cranfield: cranfield 
redneck: redneck rednecks 
witherspoon: witherspoon 
place: place places 
simon: simon 
miley: miley 
marked: marked 
almost: almost 
unto: unto 
identifiable: identifiable 
lamalfa: lamalfa 
sheriff: sheriff 
father: fathers father 
connected: connected 
sherbrooke: sherbrooke 
coachella: coachella 
mavis: mavis 
jump: jumps jump 
happening: happening 
taught: taught 
sangerine: sangerine 
weeze: weeze 
smile: smiles smile 
sip: sip 
tracy: tracy 
hiss: hiss 
matte: matte 
nogar: nogar 
baller: baller 
quittin: quittin 
dirtiest: dirtiest 
stick: sticks stick 
thee: thee 
yhung: yhung 
rucker: rucker 
perched: perched 
initially: initially 
dabbing: dabbing 
kase: kase 
sedano: sedano 
jinx: jinx 
wind: wind winds 
troop: troop troops 
shenandoah: shenandoah 
mercury: mercury 
climbed: climbed 
ramsey: ramsey 
luj: luj 
jenkins: jenkins 
steak: steak 
clapping: clapping 
blocked: blocked 
stream: stream 
fixplay: fixplay 
jrkellyrocks: jrkellyrocks 
guideline: guidelines 
breakdown: breakdown 
randy: randy 
dolly: dolly 
transmitted: transmitted 
down: downs 
action: action actions 
boney: boney 
scott: scott 
gruska: gruska 
portion: portions 
joni: joni 
slow: slow 
hed: hed 
gladewater: gladewater 
command: command 
sylvain: sylvain 
michael: michael michaels 
judgement: judgement 
eldredge: eldredge 
chili: chili 
excuse: excuse 
mudhole: mudhole 
velcro: velcro 
earlybird: earlybird 
proper: proper 
mccoy: mccoy 
following: following 
pleasure: pleasure 
singing: singing 
brett: brett 
bit: bit bits 
roxanne: roxanne 
cassandra: cassandra 
arise: arise 
trailer: trailer 
temper: temper 
producer: producer 
tampoco: tampoco 
viva: viva 
cruise: cruise 
reaching: reaching 
erick: erick 
empty: empty 
pandemic: pandemic 
kokomo: kokomo 
hank: hank 
beneficiary: beneficiaries 
ballroom: ballroom 
savage: savage 
dressed: dressed 
performer: performer 
stuart: stuart 
phase: phase 
enjoyed: enjoyed 
board: board 
rapidly: rapidly 
benyounes: benyounes 
dunn: dunn 
sentence: sentence 
rm: rm 
noel: noel 
vulnerable: vulnerable 
klein: klein 
ilomilo: ilomilo 
tominaga: tominaga 
albert: albert 
reached: reached 
seed: seed 
inferior: inferior 
attention: attention 
pouring: pouring 
def: def 
magnetic: magnetic 
bounty: bounty 
reversed: reversed 
va: va 
fading: fading 
frey: frey 
brokeback: brokeback 
agreed: agreed 
side: side 
tema: tema 
dentro: dentro 
unhappily: unhappily 
cma: cma 
chad: chad 
messenger: messenger 
sonier: sonier 
software: software 
turnin: turnin 
liza: liza 
seamstress: seamstress 
jessi: jessi 
hat: hats hat 
fighting: fighting 
prc: prc 
manny: manny 
trusted: trusted 
melody: melodies melody 
sailed: sailed 
rascal: rascal 
tonks: tonks 
entertaining: entertaining 
suicidal: suicidal 
bed: bed beds 
helpin: helpin 
portuguese: portuguese 
droogie: droogie 
press: press 
bay: bay 
queenadreena: queenadreena 
electric: electric 
maggio: maggio 
biela: biela 
privacy: privacy 
honna: honna 
slang: slang 
joy: joy 
without: without 
money: money 
lafarge: lafarge 
alexi: alexi 
prom: prom 
sheeran: sheeran 
gave: gave 
general: general 
watch: watch watches 
shannon: shannon 
influence: influence influences 
odd: odd 
campaign: campaign 
gu: gus 
randomized: randomized 
ghost: ghosts ghost 
humor: humor 
sutherland: sutherland 
famed: famed 
http: https http 
booklet: booklet 
sinceros: sinceros 
periscope: periscope 
inherently: inherently 
studio: studios studio 
sheet: sheet sheets 
polaroid: polaroids 
baker: baker 
five: five 
juxtaposition: juxtaposition 
gw: gw 
try: try 
handing: handing 
ahora: ahora 
onstage: onstage 
blackpool: blackpool 
melodically: melodically 
limit: limit 
mamma: mamma 
ex: ex 
memphis: memphis 
engineering: engineering 
cloud: clouds cloud 
edgeler: edgeler 
sickest: sickest 
broke: broke 
ruined: ruined 
calamity: calamity 
old: old 
destination: destination 
aaron: aaron 
nominee: nominees 
said: said 
panderin: panderin 
guilt: guilt 
smoke: smoke 
flogging: flogging 
globe: globes globe 
niva: niva 
daze: daze 
brussel: brussel 
exactly: exactly 
presumptuous: presumptuous 
treat: treat 
completely: completely 
promoting: promoting 
crooner: crooners 
sabyn: sabyn 
disambiguation: disambiguation 
scotian: scotian 
regret: regret regrets 
fowler: fowler 
lonely: lonely 
mock: mocks 
several: several 
additional: additional 
bird: birds bird 
smb: smb 
winterkush: winterkush 
gold: gold 
wv: wv 
estar: estar 
merkules: merkules 
smokestack: smokestack 
spruill: spruill 
vinyl: vinyl vinyls 
boondox: boondox 
problem: problem problems 
rabinowitz: rabinowitz 
plaza: plaza 
specific: specific 
primary: primary 
scathing: scathing 
stoop: stoop 
onto: onto 
rca: rca 
november: november 
metaphor: metaphor metaphors 
smarter: smarter 
trampoline: trampoline 
murphy: murphy 
luke: luke 
nina: nina 
houston: houston 
laugh: laughs laugh 
spare: spare 
environmental: environmental 
marking: marking 
billie: billie 
total: total 
antonoff: antonoff 
toten: toten 
simply: simply 
copyright: copyright 
zara: zara 
accused: accused 
compete: compete 
illicit: illicit 
nomination: nominations nomination 
trist: trist 
jamie: jamie 
star: star stars 
holman: holman 
bouncing: bouncing 
departure: departure 
flat: flat 
proceeded: proceeded 
gather: gather 
notable: notable 
subtle: subtle 
online: online 
dacus: dacus 
sang: sang 
release: release releases 
indie: indie 
updegraft: updegraft 
theory: theory theories 
idea: idea 
possession: possessions 
sickers: sickers 
fluke: fluke 
livestream: livestream 
freed: freed 
upbringing: upbringing 
public: public 
nicko: nicko 
today: today 
lang: lang 
helped: helped 
vant: vant 
others: others 
belgium: belgium 
krasavec: krasavec 
farmer: farmer 
starr: starr 
rode: rode 
contrasting: contrasting 
disliked: disliked 
clementine: clementine 
gaze: gaze 
projection: projection 
emmylou: emmylou 
village: village 
machine: machine 
tumultuous: tumultuous 
speech: speech 
oasis: oasis 
showdown: showdown 
hardest: hardest 
nederland: nederlands 
makenzie: makenzie 
forgive: forgive 
damned: damned 
painted: painted 
cussed: cussed 
celia: celia 
dating: dating 
olvidarme: olvidarme 
erg: erg 
graven: graven 
everly: everly 
swiftness: swiftness 
irwin: irwin 
velvet: velvet 
cuttin: cuttin 
shawn: shawn 
boygenius: boygenius 
irish: irish 
indian: indian indians 
hallyday: hallyday 
xplicit: xplicit 
pours: pours 
inside: inside 
bound: bound 
big: big 
divorce: divorce 
supreme: supreme 
border: border 
battlefield: battlefield 
dark: dark 
late: late 
solve: solve 
grass: grass 
piece: pieces piece 
lyric: lyric lyrics 
interestingly: interestingly 
kicking: kicking 
brandy: brandy 
bloody: bloody 
god: god gods 
got: got 
hearkened: hearkened 
attached: attached 
lesssons: lesssons 
sketo: sketo 
italic: italics 
plain: plain 
eagle: eagles 
bench: bench 
accepting: accepting 
high: highs high 
charlottesville: charlottesville 
cena: cena 
substance: substance 
tussled: tussled 
pete: pete 
dey: dey 
speight: speight 
untamed: untamed 
puse: puse 
begged: begged 
bo: bo 
spoil: spoil 
kenneth: kenneth 
afterglow: afterglow 
glizzy: glizzy 
prescription: prescription 
hyannis: hyannis 
lethal: lethal 
suffice: suffice 
headlight: headlights 
group: group 
mink: mink 
stepped: stepped 
talk: talks talk 
murder: murder murders 
elvis: elvis 
tired: tired 
tree: tree trees 
grinned: grinned 
grandmother: grandmother 
optimism: optimism 
unable: unable 
tompkins: tompkins 
planning: planning 
ford: ford 
dusty: dusty 
warren: warren 
life: life lives 
track: tracks track 
wet: wet 
skaville: skaville 
released: released 
north: north 
isabela: isabela 
bridge: bridges bridge 
goddamn: goddamn 
cog: cog 
indolence: indolence 
kissed: kissed 
sweet: sweet 
code: codes code 
robe: robes 
blowin: blowin 
history: history 
merli: merli 
que: que 
walker: walker 
eggnog: eggnog 
interfered: interfered 
jenson: jenson 
lachow: lachow 
prevodi: prevodi 
crawdaddy: crawdaddy 
primus: primus 
hulett: hulett 
quartet: quartet 
comfortable: comfortable 
serving: serving 
scunthorpe: scunthorpe 
custom: custom 
debut: debut 
jessy: jessy 
phone: phone 
componer: componer 
rescue: rescue 
gravity: gravity 
crowe: crowe 
passion: passion 
sebii: sebii 
steer: steers 
intro: intro 
fling: fling 
flavio: flavio 
marry: marry 
celesta: celesta 
freaked: freaked 
sep: sep 
issued: issued 
bali: bali 
straw: straw 
byrne: byrne 
circle: circle circles 
lmp: lmp 
light: light lights 
clip: clip clips 
travis: travis 
certification: certifications 
pedal: pedal 
cbs: cbs 
hasta: hasta 
best: best 
leader: leader 
airline: airlines 
allegedly: allegedly 
seemingly: seemingly 
relevant: relevant 
soundcheck: soundcheck 
vice: vice 
maytals: maytals 
auditorium: auditorium 
congratulated: congratulated 
bashers: bashers 
waging: waging 
tran: tran 
jonathon: jonathon 
yoko: yoko 
levon: levon 
hypnotic: hypnotic 
congratulation: congratulations 
people: people 
target: target 
hide: hide 
gentry: gentry 
finlay: finlay 
gahr: gahr 
bearing: bearing 
standin: standin 
fair: fair 
donath: donath 
bisengalieva: bisengalieva 
whittaker: whittaker 
mistake: mistake mistakes 
impressed: impressed 
particular: particular 
anyway: anyway 
credit: credits credit 
stunningly: stunningly 
intoxication: intoxication 
eleven: eleven 
hedonistic: hedonistic 
biblical: biblical 
momento: momento 
sparked: sparked 
blazing: blazing 
rival: rival 
barbiturate: barbiturates 
cliff: cliff 
mellotron: mellotron 
purgatory: purgatory 
slowcore: slowcore 
fue: fue 
polo: polo 
felt: felt 
nolesto: nolesto 
type: type types 
gaa: gaa 
character: characters character 
sinner: sinner 
hand: hand hands 
johnston: johnston 
multiple: multiple 
decision: decision decisions 
carlson: carlson 
translation: translation translations 
vol: vol 
eventually: eventually 
bronson: bronson 
mental: mental 
agarr: agarr 
dont: dont 
berywam: berywam 
gmpresents: gmpresents 
superior: superior 
officially: officially 
campbell: campbell 
suspicious: suspicious 
phoenix: phoenix 
removal: removal 
karter: karter 
kfresh: kfresh 
hultquist: hultquist 
mckenzie: mckenzie 
missed: missed 
resto: resto 
crescent: crescent 
normie: normie 
lama: lama 
penned: penned 
bullet: bullets bullet 
low: low lows 
upper: upper 
embed: embed 
theater: theater 
perkins: perkins 
dynasty: dynasty 
nice: nice 
chameleon: chameleon 
lie: lie 
blushing: blushing 
ballerina: ballerina 
childers: childers 
steppin: steppin 
gigi: gigi 
change: changes change 
plug: plug 
southern: southern 
feelin: feelin 
emotes: emotes 
couple: couple 
wandering: wandering 
flex: flex 
flavoured: flavoured 
reputation: reputation 
porsches: porsches 
puttin: puttin 
pant: pants 
holland: holland 
depend: depend 
ringo: ringo 
spidey: spidey 
gogle: gogle 
lit: lit 
store: stores store 
roof: roof 
traditional: traditional 
layered: layered 
granny: granny 
martone: martone 
alisan: alisan 
jessica: jessica 
step: step steps 
thorne: thorne 
fireball: fireball 
prof: proves 
verified: verified 
hammond: hammond 
masculine: masculine 
pr: prs 
hailey: hailey 
accident: accident 
adam: adams adam 
darling: darling 
voisine: voisine 
latte: lattes latte 
part: parts part 
everythin: everythin 
anthem: anthems anthem 
justin: justin 
speaker: speaker 
priest: priest 
ad: ad 
difference: difference differences 
fenty: fenty 
harrowing: harrowing 
railroad: railroad 
hated: hated 
pie: pie 
mindless: mindless 
civil: civil 
whisper: whisper whispers 
hub: hub 
packer: packers 
primera: primera 
bersetzungen: bersetzungen 
solo: solo 
cynic: cynics 
skouras: skouras 
leveller: levellers 
wi: wi 
coinciding: coinciding 
twitty: twitty 
dungeon: dungeon 
versa: versa 
copyist: copyist 
stewart: stewart 
nation: nation 
tennman: tennman 
description: description 
sally: sally 
chapman: chapman 
roe: roe 
team: teams team 
incredible: incredible 
earth: earth 
vuernick: vuernick 
way: ways way 
met: met 
interview: interview interviews 
two: two 
alright: alright 
promise: promise promises 
escuchando: escuchando 
rhett: rhett 
artist: artist artists 
seattle: seattle 
movement: movement 
album: albums album 
ungovernable: ungovernable 
arrive: arrive 
clifford: clifford 
huntin: huntin 
disapproval: disapproval 
sideline: sidelines 
lennon: lennon 
fore: fore 
fiction: fiction 
haha: haha 
hudson: hudson 
alex: alex 
masturbate: masturbate 
wrld: wrld 
gucci: gucci 
previewed: previewed 
rude: rude 
turco: turco 
cracked: cracked 
caballo: caballo 
platonic: platonic 
renowned: renowned 
hogni: hogni 
sonique: sonique 
reef: reeves 
melton: melton 
pentatonix: pentatonix 
surgery: surgery 
dawg: dawg 
nehederet: nehederet 
producing: producing 
heartless: heartless 
weller: weller 
dry: dry 
apologetic: apologetic 
reese: reese 
smashed: smashed 
clough: clough 
statement: statement 
extreme: extreme 
hipster: hipster 
affection: affection 
answer: answer 
receive: receive 
constantly: constantly 
norfolk: norfolk 
tucker: tucker 
danko: danko 
unreleased: unreleased 
traveler: traveler 
question: questions question 
steve: steve 
collar: collar 
reach: reach 
leh: leh 
garanh: garanh 
notorious: notorious 
outlaw: outlaws outlaw 
wanted: wanted 
dissatisfaction: dissatisfaction 
para: para 
ilysm: ilysm 
dorado: dorado 
gynaecology: gynaecology 
kitchen: kitchen 
vedetta: vedetta 
erika: erika 
parachute: parachute 
interscope: interscope 
budding: budding 
dis: diss 
map: map 
diana: diana 
caleb: caleb 
indiana: indiana 
delusion: delusion 
scanning: scanning 
rockin: rockin 
certified: certified 
slip: slip 
ore: ores 
wave: wave waves 
discovered: discovered 
ssio: ssio 
spinning: spinning 
devin: devin 
emphatically: emphatically 
inn: inn 
hence: hence 
allied: allied 
ice: ice 
cup: cup 
v: v vs 
social: socials social 
stranger: stranger 
crucified: crucified 
cornman: cornman 
giddied: giddied 
smell: smells smell 
saccharine: saccharine 
novelty: novelty 
vance: vance 
alligator: alligator 
pt: pt 
loew: loew 
purposefully: purposefully 
apple: apples apple 
staircase: staircase 
rahmatun: rahmatun 
fulfilled: fulfilled 
smooth: smooth 
street: streets street 
colgems: colgems 
differently: differently 
voice: voice voices 
tina: tina 
animated: animated 
changed: changed 
klever: klever 
teaching: teaching 
remember: remember 
cavern: cavern 
depeche: depeche 
desire: desire 
recruited: recruited 
carlile: carlile 
torus: tori 
menahan: menahan 
forbid: forbid 
sali: sali 
dickey: dickey 
file: file 
dining: dining 
continually: continually 
authentic: authentic 
vacancy: vacancy 
stacey: stacey 
emo: emo 
stopped: stopped 
rebecca: rebecca 
sort: sort 
u: u us 
moran: moran 
compare: compares compare 
jungle: jungle 
done: done 
sings: sings 
nazarin: nazarin 
mcknight: mcknight 
nether: nether 
event: event events 
goot: goot 
biography: biography 
viola: viola 
raides: raides 
willie: willie 
neon: neon 
advice: advice 
protest: protest 
lunch: lunch 
greatest: greatest 
checked: checked 
closin: closin 
tarnished: tarnished 
academy: academy 
cmg: cmg 
horseman: horsemen 
favor: favor 
borracho: borracho 
sony: sony 
chance: chance chances 
mejor: mejor 
calmatic: calmatic 
dynastic: dynastic 
mark: marks mark 
clue: clue 
period: period 
vieja: vieja 
blake: blake 
schneider: schneider 
fanclub: fanclub 
deputy: deputy 
umaczenia: umaczenia 
staten: staten 
hinted: hinted 
dessert: dessert 
clydie: clydie 
bokm: bokm 
mashup: mashup 
journal: journals journal 
vial: vial 
toot: toots 
costell: costell 
dollykollot: dollykollot 
silly: silly 
thematic: thematic 
agradable: agradable 
apartment: apartment 
switched: switched 
aldean: aldean 
blade: blade 
constant: constant 
mia: mia 
lloyd: lloyd 
none: none 
kp: kpss 
bozzi: bozzi 
overseas: overseas 
ovsyanikova: ovsyanikova 
husky: husky 
mazer: mazer 
luckhaos: luckhaos 
cover: covers cover 
darfer: darfer 
hold: hold 
persisting: persisting 
vamp: vamp vamps 
marcos: marcos 
jealousy: jealousy 
french: french 
mal: mal 
ala: alas 
clarkston: clarkston 
alguien: alguien 
lol: lol 
folsom: folsom 
expecting: expecting 
conversation: conversation 
figment: figment 
aubrey: aubrey 
realised: realised 
yrp: yrp 
cussick: cussick 
hyland: hyland 
m: ms 
gender: genders gender 
hildegardt: hildegardt 
sophomore: sophomore 
surf: surf 
shaggy: shaggy 
quick: quick 
slept: slept 
showalter: showalter 
nature: nature 
macarons: macarons 
miche: miche 
totally: totally 
spoofing: spoofing 
really: really 
caretaker: caretakers 
thank: thank 
hiof: hiof 
buckle: buckle 
lucchese: lucchese 
leather: leather 
easily: easily 
masturbation: masturbation 
man: man 
wheel: wheel wheels 
fiddle: fiddles fiddle 
nowhere: nowhere 
bastille: bastille 
british: british 
vi: vi 
detroit: detroit 
bar: bar bars 
needle: needle 
including: including 
arrangement: arrangements arrangement 
faster: faster 
halftime: halftime 
slugger: slugger 
gough: gough 
outlook: outlook 
silhouette: silhouette 
agarra: agarra 
gabriel: gabriel 
kroq: kroq 
casi: casi 
surrealist: surrealist 
dantdm: dantdm 
magazine: magazine magazines 
oates: oates 
staple: staple staples 
complaint: complaint 
oak: oak 
pine: pines pine 
neil: neil 
xld: xld 
pattern: patterns pattern 
talked: talked 
crumpled: crumpled 
smokin: smokin 
autograph: autograph 
rising: rising 
lingua: lingua 
coffee: coffees coffee 
miscommunication: miscommunication 
whisperin: whisperin 
johnstone: johnstone 
style: style styles 
farren: farren 
deathdrop: deathdrop 
crawdad: crawdads 
sandwich: sandwich 
window: windows window 
proclamation: proclamation 
br: br 
baseball: baseball 
red: red 
fogarty: fogarty 
disaster: disaster 
larsen: larsen 
musical: musical 
rare: rare 
alltoowelltheshortfilm: alltoowelltheshortfilm 
cmt: cmt 
beach: beach 
discovering: discovering 
samia: samia 
permanent: permanent 
haw: haw 
pullin: pullin 
sternbaum: sternbaum 
phallic: phallic 
spivey: spivey 
broma: broma 
elliot: elliot 
npr: npr 
alves: alves 
letra: letra 
terre: terre 
us: uses 
hynde: hynde 
recruit: recruits 
begin: begins begin 
deadly: deadly 
wine: wine 
tequila: tequila 
robbie: robbie 
til: til 
andrew: andrew 
yela: yela 
tempo: tempo 
search: search 
greek: greek 
berry: berry 
rosin: rosin 
could: could 
bang: bang 
fucking: fucking 
baffle: baffle 
endurance: endurance 
marcus: marcus 
reality: reality 
height: heights 
february: february 
envy: envy 
amigo: amigos amigo 
gronich: gronich 
germany: germany 
coro: coro 
lockeheartt: lockeheartt 
mud: mud 
oath: oath 
nasties: nasties 
entrevista: entrevista 
hahn: hahn 
chant: chant 
milsap: milsap 
mouskouri: mouskouri 
attacked: attacked 
association: association 
described: described 
thquib: thquib 
reid: reid 
singletary: singletary 
publishing: publishing 
lia: lia 
fan: fans fan 
wake: wake wakes 
swift: swift 
infidelity: infidelity infidelities 
chat: chat 
hargrove: hargrove 
wild: wild 
sabo: sabo 
end: end ends 
strait: strait 
odetta: odetta 
belong: belong 
celos: celos 
quora: quora 
point: point 
servant: servants 
kamakawiwo: kamakawiwo 
remind: remind 
stadium: stadium 
bank: banks bank 
tamposi: tamposi 
getting: getting 
gorodetzky: gorodetzky 
leonard: leonard 
seat: seat seats 
borrowing: borrowing 
donde: donde 
example: examples example 
movin: movin 
lighten: lighten 
modest: modest 
missin: missin 
talia: talia 
sherri: sherri 
wrangler: wrangler 
cramer: cramer 
numata: numata 
arista: arista 
william: william 
move: move moves 
milestone: milestone milestones 
elle: elle 
minshik: minshik 
rescued: rescued 
lindberg: lindberg 
ragtime: ragtime 
bladder: bladder 
keyboard: keyboards keyboard 
drivin: drivin 
mc: mc 
collarbone: collarbone 
parton: parton 
chrysalis: chrysalis 
xico: xico 
knob: knob 
whispered: whispered 
roy: roy 
barroom: barroom 
peter: peter 
chipmunk: chipmunk 
featured: featured 
revenge: revenge 
pedl: pedl 
ponders: ponders 
thou: thou 
pontare: pontare 
pournouri: pournouri 
tuscaloosa: tuscaloosa 
walk: walk 
telling: telling 
kanye: kanye 
angelo: angelo 
mote: mote 
planned: planned 
nivert: nivert 
infuse: infuse 
alan: alan 
manilow: manilow 
demoned: demoned 
monarch: monarch 
deserve: deserve 
brent: brent 
upfront: upfront 
gr: gr 
something: something 
leim: leim 
turner: turner 
going: going 
gathered: gathered 
kooper: kooper 
dadood: dadood 
thinner: thinner 
surround: surrounds 
masterpiece: masterpiece 
recording: recordings recording 
need: needs need 
ashlen: ashlen 
resulting: resulting 
hope: hope hopes 
promo: promo 
engaged: engaged 
ostrich: ostrich 
lilholt: lilholt 
traigo: traigo 
gehringer: gehringer 
calbi: calbi 
sam: sam 
drew: drew 
thousand: thousand 
peer: peers 
probably: probably 
f: f 
punch: punch 
gib: gib 
laying: laying 
howl: howl 
magic: magic 
garten: garten 
situation: situations situation 
bayou: bayou 
broad: broad 
mouse: mouse 
exclusive: exclusive 
mineshaft: mineshaft 
herman: herman 
aaah: aaah 
admit: admit 
praying: praying 
shrine: shrine 
bri: bri 
cigar: cigars cigar 
fanciful: fanciful 
symphony: symphony 
wendy: wendy 
safe: safe 
ocean: ocean oceans 
cusp: cusp 
coldnima: coldnima 
righteous: righteous 
via: via 
barden: barden 
car: cars car 
fifth: fifth 
dodie: dodie 
osas: osas 
peluca: peluca 
believed: believed 
jichu: jichu 
janowski: janowski 
pavement: pavement 
frontman: frontman 
sued: sued 
sebastian: sebastian 
spending: spending 
cop: cops cop 
paralyzed: paralyzed 
appearance: appearance 
photo: photo 
huxley: huxley 
musician: musician 
jay: jay 
halloween: halloween 
dogg: dogg 
platinum: platinum 
handle: handle 
unfulfilled: unfulfilled 
wry: wry 
sidney: sidney 
peanut: peanut 
ver: ver 
revolution: revolution 
prologue: prologue 
foster: foster 
annual: annual 
nuys: nuys 
calbo: calbo 
basic: basic 
band: band bands 
viol: viol 
anorexia: anorexia 
streak: streak 
trip: trips trip 
radcliffe: radcliffe 
chicago: chicago 
goin: goin 
dish: dish 
clinging: clinging 
speechless: speechless 
leaving: leaving 
corn: corn 
butler: butler 
announce: announce 
allman: allman 
distance: distance 
chord: chords chord 
uh: uh 
inch: inch 
shirt: shirts shirt 
hopefully: hopefully 
phrasing: phrasings 
llc: llc 
nuttin: nuttin 
disrupted: disrupted 
date: date 
shop: shop 
pushing: pushing 
cooke: cooke 
buddhist: buddhist 
quisiera: quisiera 
paulette: paulette 
saddest: saddest 
please: please 
nirvanadigitalpublishing: nirvanadigitalpublishing 
wmashup: wmashup 
julien: julien 
jusvibes: jusvibes 
joined: joined 
enorme: enorme 
rigths: rigths 
stretch: stretch 
sunset: sunset 
frequently: frequently 
yelling: yelling 
field: field fields 
eviri: eviri 
byrde: byrde 
legalize: legalize 
feed: feed 
shakin: shakin 
cracker: cracker 
redemption: redemption 
eurodance: eurodance 
sight: sights sight 
ate: ate 
rebel: rebel 
sordiway: sordiway 
becky: becky 
immigrant: immigrant 
james: james 
find: find finds 
laurel: laurel 
beatle: beatle 
paranoid: paranoid 
sz: sz 
colm: colm 
meros: meros 
somehow: somehow 
feminine: feminine 
mpa: mpa 
pensando: pensando 
cornelia: cornelia 
pathway: pathway 
esto: esto 
scsp: scsp 
backing: backing 
vino: vino 
levy: levy 
botella: botella 
gumi: gumi 
fairy: fairy 
expand: expand 
paz: paz 
historian: historians 
refillable: refillable 
barking: barking 
apparent: apparent 
pimp: pimps 
dead: dead 
fuck: fuck 
namin: namin 
anita: anita 
serbian: serbian 
shiggy: shiggy 
mckenzies: mckenzies 
vulture: vulture 
definitive: definitive 
wmna: wmna 
fear: fear 
maserati: maserati 
escape: escape 
jonas: jonas 
ayer: ayer 
canci: canci 
montgomery: montgomery 
tone: tone 
rolled: rolled 
hermes: hermes 
downloads: downloads 
zane: zane 
remain: remain 
jew: jews 
dudman: dudman 
ed: ed 
kmr: kmr 
return: return 
ending: ending 
kio: kio 
norwegian: norwegian 
tho: tho 
hilt: hilts 
sail: sails 
career: career 
kendrick: kendrick 
crew: crew 
corresponded: corresponded 
king: kings king 
disgusted: disgusted 
hotter: hotter 
ukhohliwe: ukhohliwe 
steele: steele 
cable: cables 
depth: depth 
tradition: tradition 
venting: venting 
communicate: communicate 
lyricist: lyricist 
swallow: swallows 
newly: newly 
birmingham: birmingham 
booth: booth 
narrator: narrator 
reba: reba 
dvd: dvd 
eighty: eighties eighty 
established: established 
formed: formed 
plus: plus 
bite: bite 
conditional: conditional 
tigres: tigres 
numbered: numbered 
antelope: antelope 
kid: kids kid 
decker: decker 
sissom: sissom 
begging: begging 
refr: refr 
scheme: schemes 
drum: drums drum 
del: del 
simpson: simpson 
marlboro: marlboro 
marlin: marlin 
suspended: suspended 
tara: tara 
dorothea: dorothea 
copilot: copilot 
drone: drone 
yung: yung 
cavetown: cavetown 
heavy: heavy 
ki: ki 
jess: jess 
willman: willman 
land: land 
ives: ives 
embroidering: embroidering 
purposely: purposely 
redtaylorsversion: redtaylorsversion 
progress: progress progresses 
strangest: strangest 
pro: pro 
walking: walking 
follow: follow 
greg: greg 
hasselhoff: hasselhoff 
haggard: haggard 
cheer: cheer cheers 
talented: talented 
went: went 
dan: dan 
dicenzo: dicenzo 
sting: sting 
accessory: accessory 
holly: hollies holly 
posterior: posterior 
arcade: arcade 
photography: photography 
egomaniac: egomaniac 
ey: ey 
cmrra: cmrra 
community: community 
bruin: bruin 
dipp: dipp 
chlapec: chlapec 
frontal: frontal 
song: song songs 
eastwood: eastwood 
aria: aria 
hardly: hardly 
nigel: nigel 
lament: lament 
jasmin: jasmin 
struggled: struggled 
gg: gg 
pulled: pulled 
flight: flight flights 
couch: couch 
brady: brady 
main: main 
gideon: gideon 
ruisi: ruisi 
installment: installment 
mgm: mgm 
feathered: feathered 
lord: lord 
hanging: hanging 
ring: rings ring 
exile: exile 
franky: franky 
sneak: sneak 
saylor: saylor 
designed: designed 
perfectly: perfectly 
walked: walked 
short: short 
ask: ask 
erik: erik 
whose: whose 
twomad: twomad 
gwar: gwar 
fondly: fondly 
destructive: destructive 
digregorio: digregorio 
somewhere: somewhere 
started: started 
forty: forty 
womack: womack 
oldtownroad: oldtownroad 
prim: prim 
duo: duo 
enormous: enormous 
encounter: encounter 
kathy: kathy 
anyone: anyone 
q: q 
deep: deep 
challenged: challenged 
heartache: heartache heartaches 
saltine: saltines 
washpoppin: washpoppin 
companion: companions 
number: number numbers 
may: may 
know: know knows 
six: six 
godly: godly 
prime: prime 
deconstructed: deconstructed 
sometimes: sometimes 
judge: judge 
form: forms form 
riley: riley 
wrote: wrote 
diablo: diablo 
adolescence: adolescence 
susan: susan 
resnick: resnick 
approaching: approaching 
rompiendo: rompiendo 
minor: minor 
raw: raw 
disappeared: disappeared 
regard: regards 
hart: hart 
sledge: sledge 
louisville: louisville 
sedeck: sedeck 
margaret: margaret 
henson: henson 
jr: jr 
distribution: distribution 
lip: lips lip 
mr: mrs mr 
du: du 
shook: shook 
morrison: morrison 
bet: bet 
priesthood: priesthood 
cletus: cletus 
applause: applause 
ninety: ninety nineties 
starkville: starkville 
pill: pill pills 
argued: argued 
aretha: aretha 
rehearsal: rehearsal rehearsals 
sadies: sadies 
tae: tae 
rubbed: rubbed 
vitamin: vitamin 
crashed: crashed 
unspeakable: unspeakable 
pageant: pageant 
jordandropout: jordandropout 
gas: gas 
crime: crime 
minnie: minnie 
melted: melted 
seventeen: seventeen 
troubled: troubled 
lego: lego 
changing: changing 
swedish: swedish 
harvest: harvest 
muzik: muzik 
ono: ono 
caspi: caspi 
script: script 
beth: beth 
blind: blind 
weezer: weezer 
secret: secret 
poured: poured 
still: still 
midi: midi 
react: react 
cat: cat 
fire: fire 
customer: customer 
reyes: reyes 
nemraps: nemraps 
cellar: cellar 
politically: politically 
process: process 
sounded: sounded 
novo: novo 
milo: milo 
rocker: rocker rockers 
sound: sounds sound 
speculation: speculation 
backstage: backstage 
trendy: trendy 
sig: sig 
steinberg: steinberg 
rice: rice 
executive: executive 
fingertip: fingertips 
edom: edom 
hendrix: hendrix 
nme: nme 
courage: courage 
anti: anti 
gotham: gotham 
outfit: outfits outfit 
gustixa: gustixa 
yabo: yabo 
kung: kung 
creek: creeks creek 
whitegrls: whitegrls 
diplo: diplo 
shank: shanks 
drug: drug drugs 
professionally: professionally 
resort: resorts 
pledge: pledge 
reunites: reunites 
hotel: hotel 
davis: davis 
build: builds build 
banned: banned 
miranda: miranda 
kook: kook 
sippin: sippin 
praising: praising 
otr: otr 
south: south 
hiltons: hiltons 
tennessee: tennessee 
duduzinho: duduzinho 
kissin: kissin 
tovar: tovar 
rodriguez: rodriguez 
huang: huang 
anarchy: anarchy 
world: worlds world 
din: din 
underwear: underwear 
using: using 
worried: worried 
mostly: mostly 
coast: coast 
shaken: shaken 
robin: robin 
sung: sung 
chevy: chevy 
bridgers: bridgers 
bleak: bleak 
hatchet: hatchet 
mckinney: mckinney 
wage: wage 
fleur: fleur 
equal: equal 
analogue: analogue 
century: century 
maclellan: maclellan 
sorry: sorry 
klouda: klouda 
transcription: transcription 
vicious: vicious 
come: come comes 
freebird: freebird 
foggy: foggy 
garfunkel: garfunkel 
enjoy: enjoy 
awesome: awesome 
separate: separate 
haynie: haynie 
mrheada: mrheada 
instrument: instruments 
teeth: teeth 
doctor: doctors doctor 
certain: certain 
jack: jack 
marlowe: marlowe 
boyzone: boyzone 
fallon: fallon 
fake: fake 
capital: capital 
appreciated: appreciated 
error: errors 
elton: elton 
alexis: alexis 
cd: cd cds 
fallone: fallone 
kool: kool 
lap: lap 
tony: tony 
since: since 
glock: glock 
horse: horses horse 
gamer: gamer 
hundred: hundred 
cunningham: cunningham 
lana: lana 
od: od 
uto: uto 
maiden: maiden maidens 
obsessed: obsessed 
figurative: figurative 
tweeted: tweeted 
explain: explain 
knife: knife 
radio: radio 
brought: brought 
nova: nova 
fria: fria 
develop: develop 
discus: discusses discuss 
permanence: permanence 
awful: awful 
curry: curry 
job: jobs job 
candy: candy 
island: island 
send: send 
captain: captain 
worth: worth 
key: key keys 
glove: glove 
peaking: peaking 
turkish: turkish 
removed: removed 
riding: riding 
touch: touch touches 
fat: fat 
followed: followed 
yawn: yawn 
emerald: emerald 
uk: uk 
casually: casually 
juda: judas 
weekly: weekly 
company: company 
aire: aires aire 
adorable: adorable 
merle: merle 
queer: queer 
objectify: objectify 
cheek: cheek cheeks 
denise: denise 
alone: alone 
although: although 
ted: ted 
ger: ger 
grace: grace 
week: weeks week 
televised: televised 
barren: barren 
mxm: mxm 
tellin: tellin 
pensar: pensar 
grandpa: grandpas 
believe: believe 
therapy: therapy 
mother: mothers mother 
wally: wally 
atv: atv 
foray: foray 
tiktoktailgate: tiktoktailgate 
spark: spark sparks 
fast: fast 
quirky: quirky 
bottom: bottom 
eivind: eivind 
claiming: claiming 
thankful: thankful 
sealnoon: sealnoon 
globelamp: globelamp 
mullins: mullins 
glish: glish 
lighthearted: lighthearted 
designer: designer 
death: death 
church: church 
scary: scary 
taron: taron 
firework: fireworks 
solidified: solidified 
badly: badly 
nash: nash 
next: next 
baritone: baritone 
september: september 
ivan: ivan 
champagne: champagne 
crackhead: crackhead 
berg: berg 
deutsch: deutsch 
destiny: destiny 
fogerty: fogerty 
behavior: behavior 
japanese: japanese 
charting: charting 
cotten: cotten 
coyote: coyote 
air: air 
spaghetti: spaghetti 
songwriter: songwriter songwriters 
depressed: depressed 
explicit: explicit 
daisy: daisy 
tomato: tomato 
service: service 
channel: channel 
happiness: happiness 
reno: reno 
declares: declares 
fvckrender: fvckrender 
imagery: imagery 
shoulder: shoulders shoulder 
right: right rights 
ayuwoki: ayuwoki 
alcance: alcance 
restaurant: restaurants 
ballad: ballads ballad 
series: series 
mandarin: mandarin 
disappear: disappear 
strength: strength 
toda: todas 
inspired: inspired 
varying: varying 
covid: covid 
nimoy: nimoy 
charm: charm 
heart: hearts heart 
lyrical: lyrical 
ingebrigtsen: ingebrigtsen 
crawford: crawford 
ekholm: ekholm 
ruler: ruler 
brick: brick 
rip: rips rip 
name: names name 
comin: comin 
collection: collections collection 
ivory: ivory 
department: department 
tolerate: tolerate 
sign: sign 
spotted: spotted 
injektion: injektion 
romance: romance 
monkey: monkey 
humour: humour 
snowy: snowy 
tracing: tracing 
teezy: teezy 
lapid: lapid 
page: page 
von: von 
livin: livin 
grey: grey 
dood: dood 
burnin: burnin 
teach: teaches 
han: han 
isaac: isaac 
mumford: mumford 
scheming: scheming 
maher: maher 
killdozer: killdozer 
verse: verse verses 
easier: easier 
condo: condo 
fourth: fourth 
flood: flood 
transcriber: transcribers 
underwood: underwood 
rednex: rednex 
fox: fox 
giant: giants giant 
ella: ella 
trying: trying 
seguido: seguido 
axis: axis 
painkiller: painkillers 
iggy: iggy 
arm: arm arms 
hove: hove 
resch: resch 
cryptic: cryptic 
everyday: everyday 
seven: seven 
loneliness: loneliness 
cook: cook 
happen: happen 
dakota: dakota 
capture: captures capture 
everything: everything 
draw: draw 
balding: balding 
clock: clock 
rather: rather 
didier: didier 
finch: finch 
visual: visual 
box: box boxes 
bradford: bradford 
proud: proud 
blocklist: blocklist 
funk: funk 
nonetheless: nonetheless 
app: app 
party: party parties 
co: co 
respect: respect 
browne: browne 
personal: personal 
ripped: ripped 
mateen: mateen 
endless: endless 
misspells: misspells 
lalala: lalala 
ackles: ackles 
strip: strip 
play: play 
norman: norman 
sio: sio 
random: random 
golf: golf 
salty: salty 
surprised: surprised 
zuckerman: zuckerman 
announced: announced 
dared: dared 
mango: mango 
considered: considered 
passed: passed 
criticize: criticize 
mathew: mathew 
skill: skill skills 
fit: fits fit 
shower: shower 
conference: conference 
property: property 
tomarme: tomarme 
humble: humble 
superficial: superficial 
davey: davey 
monster: monster 
sampling: sampling 
baroque: baroque 
loving: loving 
lover: lovers lover 
netflix: netflix 
roll: roll 
outta: outta 
earworm: earworm 
jet: jet 
ruston: ruston 
loyalty: loyalty 
sidenote: sidenote 
tunez: tunez 
belonged: belonged 
wonderin: wonderin 
irony: irony 
supremes: supremes 
disarray: disarray 
erlend: erlend 
anders: anders 
chell: chell 
beginning: beginning 
keeping: keeping 
canady: canady 
aydan: aydan 
mosquito: mosquito 
limited: limited 
sin: sin sins 
trap: trap 
chris: chris 
tweet: tweet 
barbara: barbara 
polski: polski 
intended: intended 
nah: nah 
reiniz: reiniz 
afraid: afraid 
cardi: cardi 
aftermath: aftermath 
lasted: lasted 
warm: warm 
swagger: swagger 
degree: degrees 
minute: minutes minute 
tom: tom 
pongo: pongo 
l: ls l 
jym: jym 
managed: managed 
bummin: bummin 
barefoot: barefoot 
kevin: kevin 
contribute: contribute 
denied: denied 
happened: happened 
rape: rape 
skon: skon 
included: included 
tyme: tyme 
family: family 
might: might 
ernest: ernest 
deportee: deportee 
mahr: mahr 
cil: cil 
crack: crack 
course: course 
lou: lou 
greene: greene 
allegro: allegro 
fratellis: fratellis 
watson: watson 
misdelphia: misdelphia 
coney: coney 
lujipeka: lujipeka 
rushlow: rushlow 
twelve: twelve 
graffiti: graffiti 
glaive: glaive 
roping: roping 
billboard: billboard 
write: write 
shade: shades 
doggone: doggone 
bocelli: bocelli 
itaru: itaru 
declare: declare 
galya: galya 
decksperado: decksperado 
success: success 
otamatone: otamatone 
caiden: caiden 
hartnett: hartnett 
storyteller: storytellers 
westbury: westbury 
skynyrd: skynyrd 
interviewer: interviewer 
racist: racist 
nik: nik 
ashley: ashley 
trigwell: trigwell 
gregorian: gregorian 
fauntleroy: fauntleroy 
cake: cake 
force: force forces 
giello: giello 
nt: nt 
bloqueando: bloqueando 
jisoo: jisoo 
scummiest: scummiest 
bend: bend 
linda: linda 
mano: mano 
snoop: snoop 
na: na nas 
source: source sources 
joe: joe 
darkie: darkie 
attack: attack 
better: better 
baxter: baxter 
getaway: getaway 
luther: luther 
stardom: stardom 
chloe: chloe 
xaev: xaev 
math: math 
warner: warner 
overture: overture 
mar: mars 
repenter: repenter 
regenerate: regenerate 
traduzione: traduzione 
chalkeaters: chalkeaters 
oh: oh 
whispering: whispering 
nj: nj 
complained: complained 
empezamos: empezamos 
persuasion: persuasions 
outgrown: outgrown 
khalifa: khalifa 
lard: lard 
picking: picking 
rogers: rogers 
otherside: otherside 
proven: proven 
hrvatski: hrvatski 
regretting: regretting 
standing: standing 
cooler: coolers cooler 
completes: completes 
aisha: aisha 
discography: discography 
anoint: anoint 
douglas: douglas 
plastic: plastic 
riff: riff 
demo: demos demo 
skippin: skippin 
hater: haters 
leon: leon 
subbing: subbing 
antone: antone 
confronting: confronting 
omnom: omnom 
partes: partes 
regarding: regarding 
respective: respective 
mushroom: mushroom 
importantly: importantly 
mothgirl: mothgirl 
baptiste: baptiste 
bor: bor 
mcgovern: mcgovern 
krnfx: krnfx 
die: die 
click: click 
steady: steady 
would: would 
havin: havin 
garnered: garnered 
nervously: nervously 
nancy: nancy 
trigger: trigger 
cancel: cancel 
describes: describes 
become: become 
funnybone: funnybone 
whenever: whenever 
mclean: mclean 
sellin: sellin 
piled: piled 
plate: plate 
orchestrator: orchestrator 
ortega: ortega 
harry: harry 
scalladosis: scalladosis 
travellin: travellin 
backcatalog: backcatalog 
glee: glee 
pandering: pandering 
enlists: enlists 
itzitery: itzitery 
shaftizm: shaftizm 
cute: cute 
max: max 
definitely: definitely 
benjamin: benjamin 
wrist: wrists wrist 
stalled: stalled 
poetry: poetry 
bow: bow 
eldest: eldest 
mix: mix mixes 
radically: radically 
standard: standard 
arnold: arnold 
tether: tether 
button: buttons button 
famously: famously 
kez: kez 
sentimientos: sentimientos 
amber: amber 
gabe: gabe 
par: par 
apra: apra 
hip: hips hip 
heaven: heaven 
art: art 
raleigh: raleigh 
hubb: hubb 
blaze: blaze 
molly: molly 
closure: closure 
lifeless: lifeless 
ultimate: ultimate 
vernon: vernon 
oportunidad: oportunidad 
runaway: runaway 
effacing: effacing 
swordeo: swordeo 
lanelanelane: lanelanelane 
seeth: seeth 
gun: gun guns 
broken: broken 
african: african 
engelbert: engelbert 
cher: cher 
larry: larry 
early: early 
recap: recap 
macdonald: macdonald 
allison: allison 
jones: jones 
sunnageronimo: sunnageronimo 
sauce: sauce 
killer: killer 
renard: renard 
urban: urban 
haunting: haunting 
boyz: boyz 
commissioner: commissioner 
symbol: symbol 
quadrafonic: quadrafonic 
pain: pain 
jontti: jontti 
primetime: primetime 
died: died 
uel: uel 
hinson: hinson 
mic: mic 
small: small 
grustania: grustania 
todo: todo 
insight: insight 
california: california 
lauro: lauro 
trio: trio 
lanz: lanz 
porque: porque 
awfully: awfully 
rae: rae 
chasin: chasin 
friendly: friendly 
destroy: destroy 
sloyer: sloyer 
shark: sharks 
sun: sun 
fanbase: fanbase 
propelled: propelled 
auto: auto 
titular: titular 
dann: dann 
knowles: knowles 
gate: gate 
psycho: psycho 
stage: stages stage 
thing: thing things 
espa: espa 
shaan: shaan 
comedic: comedic 
implores: implores 
nail: nails 
ankojem: ankojem 
youngkio: youngkio 
finished: finished 
scene: scenes scene 
format: format formats 
wintertime: wintertime 
relate: relate 
innocence: innocence 
brendan: brendan 
focus: focus 
conservative: conservatives 
pa: pa 
bien: bien 
heller: heller 
rd: rd 
various: various 
disease: disease 
updated: updated 
jett: jett 
amphetamine: amphetamines 
jingle: jingle 
price: price 
cellist: cellist 
call: calls call 
holy: holy 
animal: animal 
asimilarlo: asimilarlo 
turin: turin 
get: gets get 
administration: administration 
widespread: widespread 
revolutionary: revolutionary 
mastering: mastering 
toxic: toxic 
create: create 
helfant: helfant 
token: token 
coming: coming 
maxo: maxo 
moonie: moonies 
bbc: bbc 
haut: haut 
cureton: cureton 
vocal: vocals vocal 
luzier: luzier 
interpreted: interpreted 
drama: drama 
kettle: kettle 
failure: failures failure 
retweeted: retweeted 
meaning: meaning 
ward: ward 
disregarded: disregarded 
serotonin: serotonin 
soaring: soaring 
teacher: teacher 
fujii: fujii 
creo: creo 
emma: emma 
creelman: creelman 
pond: pond 
amicus: amicus 
lung: lung lungs 
lionsgate: lionsgate 
young: young 
ifield: ifield 
heri: heri 
yeah: yeah 
junk: junk 
traitor: traitor traitors 
stim: stim 
worst: worst 
roman: roman romans 
braun: braun 
ana: ana 
commented: commented 
rerelease: rerelease 
starred: starred 
posty: posty 
abraham: abraham 
karaoke: karaoke 
regression: regression 
manchester: manchester 
foot: foot feet 
hearse: hearse 
oof: oof 
guardianes: guardianes 
zack: zack 
buenos: buenos 
fiddler: fiddler 
continental: continental 
spends: spends 
stereo: stereo 
pot: pot 
formby: formby 
building: building 
adventure: adventures 
bradlee: bradlee 
cincinnati: cincinnati 
dignified: dignified 
sacred: sacred 
fix: fix 
fixing: fixing 
visuals: visuals 
season: season seasons 
montevallo: montevallo 
ruskin: ruskin 
gown: gowns 
talbot: talbot 
kira: kira 
slowing: slowing 
post: post 
tucky: tucky 
alpine: alpine 
keep: keep keeps 
ro: ros ro 
mastered: mastered 
seek: seeks 
bastard: bastards bastard 
ike: ike 
affinity: affinity 
fairytale: fairytale 
martie: martie 
nordland: nordland 
tender: tender 
mattel: mattel 
gondek: gondek 
mily: mily 
castro: castro 
robbins: robbins 
nil: nils 
language: languages language 
inconvenience: inconvenience 
upright: upright 
distinguish: distinguish 
notch: notch notches 
bee: bee 
homage: homage 
murmelina: murmelina 
cried: cried 
sad: sad 
slick: slick 
collaboration: collaboration 
amazing: amazing 
secretly: secretly 
teaser: teaser 
inspiration: inspirations inspiration 
lafayette: lafayette 
julian: julian 
contributor: contributors contributor 
frustration: frustration frustrations 
rep: rep 
saving: saving 
ordeal: ordeal 
thicket: thicket 
hometown: hometown 
liked: liked 
relax: relax 
tecovas: tecovas 
dreamin: dreamin 
rhyme: rhyme 
allude: allude 
throwback: throwback 
spank: spanks 
korn: korn 
lived: lived 
fr: fr 
revealing: revealing 
curtis: curtis 
vega: vegas vega 
carousel: carousel 
ray: ray 
catharsis: catharsis 
watkins: watkins 
reaction: reaction 
syn: syn 
show: shows show 
single: singles single 
dagame: dagames 
powell: powell 
dedication: dedication 
though: though 
candice: candice 
blackjack: blackjack 
bbx: bbx 
emond: emond 
told: told 
lane: lane 
maybe: maybe 
xxx: xxx 
interpolate: interpolate 
developer: developers 
ignota: ignota 
aferro: aferro 
vertalingen: vertalingen 
diamond: diamond diamonds 
rooney: rooney 
murray: murray 
rendition: rendition 
appears: appears 
tune: tune tunes 
pull: pull 
stain: stains stain 
oct: oct 
decay: decay 
touring: touring 
goodbye: goodbye 
mtgremy: mtgremy 
help: help 
kylie: kylie 
bigger: bigger 
tommy: tommy 
compilation: compilation 
obvious: obvious 
armin: armin 
suga: suga 
outward: outward 
jj: jj 
pomplamoose: pomplamoose 
paste: paste 
herida: herida 
lgbtq: lgbtq 
dyke: dyke 
glamour: glamour 
jackie: jackie 
tres: tres 
judgment: judgment 
towards: towards 
richie: richie 
meticulously: meticulously 
cashmere: cashmere 
footprint: footprint 
continuing: continuing 
dangerous: dangerous 
fragment: fragments 
amc: amc 
ginger: ginger 
counting: counting 
bandit: bandit bandits 
disposition: disposition 
aor: aor 
fontaine: fontaine 
preview: preview 
globales: globales 
living: living 
ass: asses 
tall: tall 
fuse: fuse 
pepper: peppers 
messed: messed 
lenzo: lenzo 
shatter: shatter 
uhm: uhm 
sleeve: sleeve 
carline: carline 
enlist: enlist 
doughty: doughty 
sweden: sweden 
il: il 
work: works work 
ruby: ruby 
carter: carter 
dug: dug 
silent: silent 
destitute: destitute 
babylon: babylon 
support: support 
bubble: bubble bubbles 
bottleneck: bottleneck 
debate: debate 
psychedelic: psychedelic 
magill: magill 
ball: balls ball 
beauty: beauty 
title: title 
brown: browns brown 
likely: likely 
sneaker: sneakers 
final: final 
sweetest: sweetest 
gaines: gaines 
glovebox: glovebox 
england: england 
ludus: ludus 
away: away 
traveller: traveller 
optimistic: optimistic 
animator: animator 
hannah: hannah 
brentwood: brentwood 
spend: spend 
bu: bu 
disarm: disarm 
giving: giving 
federal: federal 
across: across 
folklore: folklore 
ames: ames 
san: san 
far: far 
shock: shock 
buy: buy 
tn: tn 
seara: seara 
model: model 
alwyn: alwyn 
sophie: sophie 
docter: docter 
mai: mai 
cookie: cookie 
nicolas: nicolas 
new: new 
lenny: lenny 
roblox: roblox 
bluesy: bluesy 
flatbed: flatbed 
present: present 
mari: maris 
jumped: jumped 
theft: theft 
contento: contento 
apology: apology apologies 
era: era 
shadyxv: shadyxv 
cold: cold 
dare: dare 
kentucky: kentucky 
rest: rest 
scholar: scholars 
rosanne: rosanne 
ian: ian 
walsh: walsh 
hab: hab 
becomes: becomes 
gradually: gradually 
glitter: glitter 
tfdi: tfdi 
supposed: supposed 
grateful: grateful 
maren: maren 
clarkson: clarkson 
pose: pose 
owl: owl 
soundtrack: soundtrack 
iron: iron 
received: received 
looking: looking 
fader: fader 
returning: returning 
violeta: violeta 
bengineer: bengineer 
weirdly: weirdly 
brave: brave braves 
learning: learning 
walka: walka 
dream: dreams dream 
kirsch: kirsch 
here: heres 
hang: hang 
mom: mom 
grand: grand 
exciting: exciting 
viney: viney 
emulation: emulation 
landed: landed 
walkin: walkin 
vulnerability: vulnerability 
cussing: cussing 
fahey: fahey 
evaporate: evaporate 
thug: thug 
jane: jane 
jedi: jedi 
archetype: archetype 
sherlie: sherlie 
ti: ti tis 
bean: bean 
americana: americana 
global: global 
peyroux: peyroux 
assumed: assumed 
waxahatchee: waxahatchee 
forth: forth 
biopic: biopic 
rage: rage 
layin: layin 
kevdog: kevdog 
hideaway: hideaway 
pincus: pincus 
river: river 
pledging: pledging 
lovestory: lovestory 
seem: seem 
flashback: flashback flashbacks 
namesake: namesake 
opposite: opposite 
castanhari: castanhari 
commerically: commerically 
barrera: barrera 
pity: pity 
heard: heard 
biggest: biggest 
whether: whether 
christian: christian 
javier: javier 
colorful: colorful 
durk: durk 
norte: norte 
zedd: zedd 
megamashup: megamashup 
industria: industria 
wes: wes 
vida: vida 
letter: letter letters 
giu: giu 
kilgour: kilgour 
titled: titled 
thigh: thigh 
podr: podr 
soy: soy 
hawaiian: hawaiian 
belfast: belfast 
whiskey: whiskey 
inherent: inherent 
pearl: pearl 
ahead: ahead 
wolf: wolf 
rockwell: rockwell 
carole: carole 
lonesome: lonesome 
isolated: isolated 
cullen: cullen 
reggie: reggie 
disputed: disputed 
remi: remi 
free: free 
tok: tok 
poetical: poetical 
hollywood: hollywood 
sperry: sperry 
sugg: sugg 
opry: opry 
viewer: viewer 
menace: menace 
gatos: gatos 
leave: leave 
marcantonio: marcantonio 
crystal: crystals 
nic: nic 
creates: creates 
llama: llamas llama 
ttning: ttning 
rid: rid 
beat: beat 
beer: beer beers 
madison: madison 
duckling: ducklings 
cassidi: cassidi 
inheritance: inheritance 
offical: offical 
huh: huh 
homeswitcher: homeswitcher 
doubt: doubt 
tonight: tonight 
burka: burka 
yee: yee 
diary: diary 
tench: tench 
select: select 
matter: matter 
targa: targa 
frankie: frankie 
cheat: cheat cheats 
catch: catch 
forevermore: forevermore 
inquiry: inquiry 
knock: knocks knock 
originally: originally 
pour: pour 
dove: dove 
forrest: forrest 
sitar: sitar 
read: read 
tenth: tenth 
running: running 
becoming: becoming 
melissa: melissa 
manly: manly 
wantin: wantin 
namely: namely 
aron: aron 
pure: pure 
alternative: alternative 
shaped: shaped 
dixon: dixon 
finally: finally 
corey: corey 
voss: voss 
performance: performances performance 
le: le less les 
buttrey: buttrey 
vending: vending 
ellery: ellery 
ix: ix 
conscience: conscience 
achilles: achilles 
wildcat: wildcat 
paired: paired 
confirmed: confirmed 
honestly: honestly 
serious: serious 
zombie: zombie 
jason: jason 
claimed: claimed 
comment: comments comment 
neidt: neidt 
collaborated: collaborated 
peak: peak 
merry: merry 
smoking: smoking 
citizen: citizen 
sanchez: sanchez 
ukrainian: ukrainian 
electropop: electropop 
picked: picked 
der: der 
mackin: mackin 
trumpet: trumpets trumpet 
valley: valley 
iheartradio: iheartradio 
armor: armor 
root: roots root 
remix: remix 
lukimea: lukimea 
add: add 
honest: honest 
doze: doze 
squeeze: squeeze 
wearing: wearing 
priv: priv 
miro: miro 
directly: directly 
maitland: maitland 
bought: bought 
shining: shining 
ir: ir 
fadin: fadin 
pen: pen pens 
arranger: arranger 
independence: independence 
wonpil: wonpil 
current: current 
nightbird: nightbird 
locklin: locklin 
inspire: inspire 
snuck: snuck 
older: older 
longer: longer 
web: webs 
drowned: drowned 
equation: equation 
faze: faze 
rod: rod 
fresh: fresh 
amen: amen 
eppic: eppic 
leak: leak leaks 
shepherd: shepherds 
darkest: darkest 
winslow: winslow 
trixie: trixie 
zodiac: zodiac 
jam: jam 
buzzin: buzzin 
dimension: dimension 
future: future 
funny: funny 
gangster: gangster 
vest: vest 
outen: outen 
madman: madman madmen 
quarantine: quarantine 
invisible: invisible 
rap: rap raps 
yount: yount 
witchz: witchz 
raking: raking 
toc: toc 
camille: camille 
laboriel: laboriel 
bubblegum: bubblegum 
marvel: marvel 
round: round rounds 
comfort: comfort 
especially: especially 
ol: ol 
chester: chester 
la: la las 
austin: austin 
fran: fran 
body: body 
burst: burst 
susanna: susanna 
policy: policy 
gay: gay 
program: program 
reinterpret: reinterpret 
rhone: rhone 
hung: hung 
lyn: lyn 
llamarte: llamarte 
mero: mero 
sister: sister 
sagittarius: sagittarius 
ramones: ramones 
sir: sir 
burrow: burrows 
whitebloom: whitebloom 
journey: journey 
gon: gon 
maple: maple 
creative: creative 
empire: empire 
ranting: ranting 
royal: royal 
hull: hull 
workplace: workplace 
cannot: cannot 
hayride: hayride 
irving: irving 
benson: benson 
married: married 
loser: loser 
responsabilidad: responsabilidad 
lodged: lodged 
kenny: kenny 
crossing: crossing 
tracklist: tracklist 
maria: maria 
often: often 
flannel: flannel 
slower: slower 
stress: stress 
wall: wall walls 
melky: melky 
tuviera: tuviera 
emotional: emotional 
omits: omits 
strange: strange 
breakout: breakout 
performing: performing 
fallin: fallin 
stumble: stumble 
ubem: ubem 
carne: carne 
patsy: patsy 
fiancee: fiancee 
line: line lines 
doll: dolls doll 
rolling: rolling 
repeating: repeating 
tiger: tigers 
commentary: commentary 
strayer: strayer 
dancing: dancing 
italiana: italiana 
mont: mont 
golden: golden 
katniss: katniss 
wash: washes wash 
moved: moved 
insincere: insincere 
lounge: lounge 
laredo: laredo 
upstate: upstate 
hann: hann 
watchtower: watchtower 
chick: chicks 
see: sees see 
coke: coke 
sure: sure 
staying: staying 
completamente: completamente 
pope: pope 
epic: epic 
teapot: teapot 
full: full 
earlier: earlier 
conard: conard 
virginia: virginia 
danish: danish 
fingernail: fingernails 
experience: experience experiences 
tide: tide 
callin: callin 
truglio: truglio 
miss: miss 
powerless: powerless 
latest: latest 
braden: braden 
mum: mum 
pon: pon 
boo: boo 
allen: allen 
bowie: bowie 
disney: disney 
obviously: obviously 
successful: successful 
blackout: blackout 
hot: hot 
truck: truck trucks 
mind: mind minds 
nothing: nothing 
revolves: revolves 
outro: outro 
jawga: jawga 
yearwood: yearwood 
huntington: huntington 
kingdom: kingdom 
shattered: shattered 
struggling: struggling 
nk: nk 
trust: trust 
poulton: poulton 
grone: grone 
grappling: grappling 
treuting: treuting 
lay: lay 
shrug: shrug 
kill: kill 
tempting: tempting 
bonham: bonham 
responded: responded 
mabel: mabel 
backup: backup 
rock: rock rocks 
foxboro: foxboro 
kaisson: kaisson 
poker: poker 
highly: highly 
ky: ky 
private: private 
watchman: watchman 
blackbird: blackbird 
usa: usa 
crust: crust 
hollyridge: hollyridge 
covering: covering 
skelter: skelter 
minimal: minimal 
roadkill: roadkill 
continue: continue 
sandal: sandals 
goatess: goatess 
gary: gary 
dumb: dumb 
scarecrow: scarecrow 
retains: retains 
feeling: feelings feeling 
directed: directed 
sullivan: sullivan 
drenched: drenched 
around: around 
together: together 
stray: stray 
parisian: parisian 
atlantic: atlantic 
leo: leo 
actress: actress 
mean: mean means 
contest: contest 
rediscover: rediscover 
heldens: heldens 
collective: collective 
interested: interested 
mission: mission 
landlord: landlord 
bleached: bleached 
montego: montego 
nighttime: nighttime 
gentle: gentle 
fanny: fanny fannys 
randolph: randolph 
spitting: spitting 
rodeo: rodeo 
pool: pool 
cocker: cocker 
willing: willing 
preface: preface 
tiempos: tiempos 
christopher: christopher 
mics: mics 
stealin: stealin 
cobb: cobb 
donoghue: donoghue 
unsure: unsure 
sunny: sunny 
warning: warnings warning 
kiss: kiss 
srpski: srpski 
rashawn: rashawn 
lucifer: lucifer 
image: image images 
maxime: maxime 
etta: etta 
soldier: soldier 
flirt: flirt 
put: puts put 
card: cards 
leroy: leroy 
willam: willam 
caused: caused 
location: locations 
kingshofu: kingshofu 
alexander: alexander 
second: seconds second 
josh: josh 
solomon: solomon 
whitney: whitney 
polish: polish 
frank: frank 
mi: mis mi 
nunca: nunca 
tyler: tyler 
robert: robert roberts 
frog: frog 
merely: merely 
lin: lin 
lnk: lnk 
daylight: daylight 
letting: letting 
glow: glow 
clicked: clicked 
monolyth: monolyth 
clerk: clerk 
paula: paula 
split: split 
identity: identities 
fog: fog 
byrom: byrom 
siamese: siamese 
prospector: prospector 
hormel: hormel 
listener: listener listeners 
lily: lily 
bukovac: bukovac 
shout: shout 
goose: goose 
nazareth: nazareth 
mixx: mixx 
patience: patience 
comenz: comenz 
tackled: tackled 
hausmann: hausmann 
cursed: cursed 
wartime: wartime 
emerson: emerson 
addicted: addicted 
trench: trenches 
tack: tack 
age: age 
however: however 
doug: doug 
beef: beef beefs 
serf: serves 
separated: separated 
carusoe: carusoe 
filum: fila 
landon: landon 
gently: gently 
hindi: hindi 
traded: traded 
beanie: beanie 
rk: rk 
novello: novello 
watching: watching 
wonderstruck: wonderstruck 
fold: folds 
reported: reported 
humorous: humorous 
collins: collins 
henley: henley 
helter: helter 
wait: wait 
pronounce: pronounce 
rider: riders rider 
regional: regional 
songwriting: songwriting 
beggin: beggin 
flame: flames flame 
proving: proving 
parted: parted 
zubin: zubin 
surreal: surreal 
floyd: floyd 
string: string strings 
frailty: frailty 
w: w 
fight: fight fights 
shinin: shinin 
yakus: yakus 
ilya: ilya 
pistol: pistol 
angelica: angelica 
natalie: natalie 
nominated: nominated 
working: working 
adultery: adultery 
bryan: bryan 
twin: twin twins 
sixty: sixty sixties 
platform: platforms 
intention: intentions 
within: within 
stair: stairs 
pickin: pickin 
headphone: headphones 
charlotte: charlotte 
vespodd: vespodd 
bumblebee: bumblebee 
noacf: noacf 
portray: portray 
arkangel: arkangel 
marc: marc 
room: room 
petty: petty 
aidan: aidan 
chainsmokers: chainsmokers 
gin: gin 
dr: dr 
despite: despite 
manner: manners 
fifteen: fifteen 
lower: lower 
accept: accept 
traducere: traducere 
aguiar: aguiar 
partnership: partnership 
tre: tre 
caledonia: caledonia 
loses: loses 
grandayy: grandayy 
greater: greater 
learned: learned 
confined: confined 
corner: corner 
laylines: laylines 
score: score 
woah: woah 
syncing: syncing 
sayin: sayin 
curious: curious 
karel: karel 
balcony: balcony 
trespassing: trespassing 
misery: misery 
tried: tried 
welcome: welcome 
bailey: bailey 
godwin: godwin 
comercializar: comercializar 
joanna: joanna 
daughter: daughter daughters 
nike: nike 
xp: xp 
wa: wa 
triumphant: triumphant 
giddy: giddy 
scotch: scotch 
medley: medley 
sand: sand 
marketing: marketing 
scofield: scofield 
ilovefriday: ilovefriday 
socan: socan 
harmonizing: harmonizing 
iscf: iscf 
complex: complex 
non: non 
keywest: keywest 
guy: guy guys 
holding: holding holdings 
lumineers: lumineers 
lovely: lovely 
sag: sag 
selected: selected 
kinfolk: kinfolks 
minstrel: minstrel 
nodal: nodal 
daniel: daniels daniel 
dion: dion 
ambience: ambience 
meadow: meadows 
yuki: yuki 
lissie: lissie 
roussos: roussos 
grown: grown 
stereogum: stereogum 
dutch: dutch 
kristin: kristin 
afternoon: afternoon 
dicen: dicen 
hinting: hinting 
cyn: cyn 
droppin: droppin 
mckenna: mckenna 
tanukes: tanukes 
dwarf: dwarf 
daryle: daryle 
tik: tik 
behind: behind 
continuation: continuation 
zalc: zalc 
rhys: rhys 
costume: costume costumes 
sensitive: sensitive 
conjures: conjures 
creatividad: creatividad 
metal: metal 
realizes: realizes 
tradu: tradu 
carroll: carroll 
olvidan: olvidan 
steel: steel 
kinda: kinda 
blown: blown 
rooster: rooster 
childhood: childhood 
ann: ann 
bitch: bitch bitches 
mackillop: mackillop 
patriarchy: patriarchy 
abusive: abusive 
nathan: nathan 
ml: ml 
sawin: sawin 
sisk: sisk 
critic: critics critic 
smokey: smokey 
nu: nu 
cared: cared 
nir: nir 
sarcastic: sarcastic 
trent: trent 
tremorefire: tremorefire 
butthepmo: butthepmo 
morgane: morgane 
tv: tv 
moanin: moanin 
original: original 
superbowl: superbowl 
thirty: thirty 
clarice: clarice 
kathryn: kathryn 
bruce: bruce 
rumor: rumors 
cometh: cometh 
attribute: attribute 
cuando: cuando 
weekend: weekend 
bolder: bolder 
knew: knew 
chorus: chorus 
ran: ran 
forgotten: forgotten 
conde: conde 
obligation: obligations 
undertaker: undertaker 
smaller: smaller 
benedict: benedict 
want: want wants 
uproxx: uproxx 
dave: dave 
quoted: quoted 
mandolin: mandolin 
complexity: complexity 
drinkin: drinkin 
monica: monica 
piss: piss 
elementary: elementary 
traduzioni: traduzioni 
prison: prison 
wesley: wesley 
green: green 
middle: middle 
everyone: everyone 
esp: esp 
detail: details detail 
racism: racism 
bride: bride 
stanza: stanza 
tarnation: tarnation 
martina: martina 
home: home homes 
doolin: doolin 
sickening: sickening 
impel: impel 
carl: carl 
promised: promised 
pagsasalin: pagsasalin 
impossibility: impossibility 
burned: burned 
marty: marty 
reference: reference references 
admirer: admirer 
babe: babe 
apologized: apologized 
viral: viral 
donelly: donelly 
fell: fell 
canada: canada 
familiar: familiar 
roadtrip: roadtrip 
rarely: rarely 
sabrina: sabrina 
share: share shares 
seamlessly: seamlessly 
flew: flew 
sesac: sesac 
dvncy: dvncy 
episode: episode 
refrigerator: refrigerator 
tengas: tengas 
kingfisher: kingfisher 
yankovic: yankovic 
outside: outside 
molesto: molesto 
flake: flakes 
mcdowell: mcdowell 
reservoir: reservoir 
eye: eye eyes 
devlin: devlin 
football: football 
borrowed: borrowed 
geez: geez 
hanes: hanes 
local: local 
loxive: loxive 
bonus: bonus 
uga: uga 
crash: crash 
double: double 
clout: clout 
blamed: blamed 
recited: recited 
carrie: carrie 
dorathea: dorathea 
polygram: polygram 
ngamo: ngamo 
joaquin: joaquin 
leg: leg legs 
tienes: tienes 
capitol: capitol 
reptilelegit: reptilelegit 
asleep: asleep 
hear: hear 
emotive: emotive 
sunday: sundays sunday 
bloom: blooms 
metropolis: metropolis 
waiting: waiting 
horan: horan 
slowly: slowly 
trem: trem 
duet: duet 
jaime: jaime 
juliano: juliano 
moten: moten 
seth: seth 
peck: peck 
ascap: ascap 
freestyle: freestyle 
xito: xito 
ragin: ragin 
genre: genres genre 
darby: darby 
gifted: gifted 
rusted: rusted 
hancock: hancock 
mina: mina 
rhetoric: rhetoric 
strongly: strongly 
nervous: nervous 
wood: woods 
geto: geto 
morello: morello 
prophesize: prophesize 
motorcycle: motorcycles 
je: je 
loss: loss 
un: un 
khari: khari 
stare: stare 
lovin: lovin 
sal: sal 
run: run runs 
griffin: griffin 
outlawed: outlawed 
backstrap: backstrap 
hologram: holograms 
gospel: gospel 
festival: festival 
hustlin: hustlin 
squashed: squashed 
demonic: demonic 
basically: basically 
duel: duel 
recuerdo: recuerdo 
joann: joann 
solar: solar 
dash: dash 
forcing: forcing 
kacey: kacey 
txwn: txwn 
began: began 
remixes: remixes 
upset: upset 
slashed: slashed 
cel: cel 
shut: shut 
cash: cash 
tryna: tryna 
scream: scream 
wilde: wilde 
siento: siento 
stay: stays stay 
microsoft: microsoft 
angela: angela 
library: library 
mario: mario 
roam: roam 
xx: xx 
shack: shacks 
traditionally: traditionally 
wing: wing wings 
destined: destined 
faith: faith 
literally: literally 
artwork: artwork 
uplifting: uplifting 
ta: ta 
spencer: spencer 
yunk: yunk 
woke: woke 
waited: waited 
pasiva: pasiva 
according: according 
evander: evander 
york: york 
wagon: wagon 
edgar: edgar 
bonn: bonn 
showed: showed 
cast: cast 
everlife: everlife 
district: district 
harm: harm 
thinkin: thinkin 
buda: buda 
fi: fi 
rvshvd: rvshvd 
gnocato: gnocato 
brad: brad 
ridge: ridge 
pase: pase 
brock: brock 
worn: worn 
america: america 
sipping: sipping 
stupider: stupider 
praised: praised 
felp: felp 
salah: salah 
thom: thom 
wigz: wigz 
wooden: wooden 
floor: floor 
avi: avi 
explosion: explosion 
santiago: santiago 
stood: stood 
national: national 
reddit: reddit 
driving: driving 
sawtooth: sawtooth 
jeevas: jeevas 
virgin: virgin 
looked: looked 
shinunoga: shinunoga 
kept: kept 
convolk: convolk 
fletcher: fletcher 
slowin: slowin 
copy: copy copies 
stoked: stoked 
remover: remover 
assumption: assumptions assumption 
atwood: atwood 
starin: starin 
reachin: reachin 
concert: concerts concert 
phair: phair 
wallet: wallet 
tsui: tsui 
hall: hall 
apart: apart 
tate: tate 
denilson: denilson 
sane: sane 
nana: nana 
woo: woo 
dacraftyboi: dacraftyboi 
english: english 
act: act 
ten: ten 
dido: dido 
iero: iero 
foolish: foolish 
dedicarle: dedicarle 
louisiana: louisiana 
songtrust: songtrust 
maddie: maddie 
sandcastles: sandcastles 
savior: savior 
repair: repair 
percussion: percussion 
london: london 
luis: luis 
user: user 
soggy: soggy 
hoodies: hoodies 
betty: betty 
missing: missing 
blue: blue blues 
patty: patty 
sing: sing 
ignored: ignored 
equipped: equipped 
office: office 
artistas: artistas 
ha: ha 
livy: livy 
lock: locks lock 
swimmin: swimmin 
sydney: sydney 
maturity: maturity 
keychain: keychain 
evident: evident 
county: county 
disseminating: disseminating 
rush: rush 
shoot: shoot 
taco: taco 
notion: notion 
oxygen: oxygen 
friday: friday 
consolidado: consolidado 
sverige: sverige 
dalton: dalton 
colton: colton 
rule: rule rules 
laid: laid 
embraced: embraced 
grip: grip 
harrell: harrell 
gracie: gracie 
chill: chill 
rear: rear 
blooded: blooded 
huey: huey 
vh: vh 
playoff: playoffs 
blowing: blowing 
prior: prior 
jimmy: jimmy 
traveling: traveling 
set: sets set 
improv: improv 
cross: cross 
book: book books 
sweatin: sweatin 
reuniting: reuniting 
portugu: portugu 
reacted: reacted 
carmichael: carmichael 
gera: gera 
leaf: leaves 
filthy: filthy 
e: es e 
programmer: programmer 
gambatese: gambatese 
oughta: oughta 
halo: halo 
peaceful: peaceful 
traductions: traductions 
grin: grin 
pao: pao 
givin: givin 
day: day days 
thought: thought thoughts 
outer: outer 
shove: shove 
fascinated: fascinated 
kuk: kuk 
springsteen: springsteen 
montana: montana 
waste: waste 
ikywt: ikywt 
mick: mick 
lincoln: lincoln 
elated: elated 
shake: shakes shake 
fallout: fallout 
overwhelmed: overwhelmed 
ole: ole 
throughout: throughout 
shy: shy 
settle: settle 
radiance: radiance 
williamstown: williamstown 
muscle: muscle 
chariot: chariot 
sims: sims 
sober: sober 
reiner: reiner 
give: give gives 
huge: huge 
effigy: effigy 
zerator: zerator 
july: july 
wurlitzer: wurlitzer 
always: always 
pump: pump 
ireland: ireland 
barely: barely 
colter: colter 
patient: patient 
dynamic: dynamic 
lucy: lucy 
explanation: explanation 
rance: rance 
care: cares care 
groove: groove 
manning: manning 
busy: busy 
jennate: jennate 
ernie: ernie 
bat: bat 
mike: mike 
miaaaaa: miaaaaa 
drowns: drowns 
ouimette: ouimette 
muchdank: muchdank 
calamaro: calamaro 
conundrum: conundrum 
embodiment: embodiment 
jeff: jeff 
recognition: recognition 
asked: asked 
include: include 
poison: poison 
guzm: guzm 
stone: stone stones 
wanda: wanda 
shroud: shroud 
indelible: indelible 
trick: tricks trick 
holiday: holiday holidays 
mason: mason 
bowl: bowl 
vessel: vessel 
falsely: falsely 
droit: droit 
excl: excl 
negro: negro 
bath: bath 
haute: haute 
dolcemente: dolcemente 
gautier: gautier 
firewater: firewater 
turkey: turkey 
frail: frail 
starring: starring 
hath: hath 
veltz: veltz 
howell: howell 
bella: bella 
raised: raised 
acted: acted 
driver: drivers 
united: united 
governor: governor 
kobalt: kobalt 
curiosity: curiosity 
onion: onion 
eazy: eazy 
composed: composed 
forgetting: forgetting 
trail: trail 
scared: scared 
yankee: yankee 
pendulum: pendulum 
worry: worry 
annoying: annoying 
ellisor: ellisor 
ab: ab 
mail: mail 
hears: hears 
concept: concept 
conner: conner 
clap: clap 
museum: museum 
spy: spy 
pedas: pedas 
mashups: mashups 
loud: loud 
used: used 
wordplay: wordplay 
por: por 
yay: yay 
acoustic: acoustic 
noted: noted 
chikili: chikili 
delicate: delicate 
bless: bless 
flare: flare 
space: space 
nat: nat 
clyde: clyde 
reflects: reflects 
mankind: mankind 
breeze: breeze 
fun: fun 
orange: orange 
outage: outage 
min: min 
homegrown: homegrown 
major: major 
libido: libido 
pander: pander 
bradley: bradley 
temix: temix 
laroi: laroi 
unearthed: unearthed 
thurl: thurl 
publisher: publisher 
seeker: seekers 
navy: navy 
factory: factory 
portrays: portrays 
stinking: stinking 
compartmentalize: compartmentalize 
canyon: canyons canyon 
defiance: defiance 
humiliated: humiliated 
disappointed: disappointed 
wildest: wildest 
rumored: rumored 
interpretation: interpretations interpretation 
playin: playin 
alexcruz: alexcruz 
lt: lt 
natewantstobattle: natewantstobattle 
rey: rey 
plot: plot 
victor: victor 
shakespeare: shakespeare 
stuck: stuck 
annoyance: annoyance 
indication: indication 
customatrix: customatrix 
ear: ears ear 
n: n 
nonbinary: nonbinary 
shiny: shiny 
wayne: wayne 
bebo: bebo 
attraction: attraction 
forgot: forgot 
mandalorian: mandalorian 
religious: religious 
reinterpreted: reinterpreted 
bond: bonds 
dwayne: dwayne 
level: level 
ron: ron 
holdin: holdin 
spat: spat 
butter: butter 
complain: complain 
pok: pok 
remembered: remembered 
tu: tu 
thompson: thompson 
ft: ft 
mhmm: mhmm 
emmett: emmett 
dobro: dobro 
echo: echo echoes 
introducing: introducing 
bollman: bollman 
shelf: shelf 
porsche: porsche 
hooked: hooked 
encapsulated: encapsulated 
krauss: krauss 
christine: christine 
layer: layers 
khan: khan 
dress: dress dresses 
negative: negative 
shined: shined 
chaotic: chaotic 
actually: actually 
riverdale: riverdale 
mcd: mcd 
forteo: forteo 
wondered: wondered 
ravenscroft: ravenscroft 
ong: ong 
brighten: brighten 
wichita: wichita 
weave: weave 
synths: synths 
reznor: reznor 
roba: roba 
habit: habit 
showing: showing 
hair: hair 
bilmuri: bilmuri 
scoop: scoop 
classic: classic classics 
billy: billy 
llena: llena 
x: x 
grew: grew 
wynette: wynette 
drowning: drowning 
conflict: conflict 
aol: aol 
carey: carey 
icon: icon 
siempre: siempre 
lena: lena 
hopin: hopin 
jwittz: jwittz 
queen: queen queens 
rapping: rapping 
abramus: abramus 
broader: broader 
bull: bull 
genesis: genesis 
realized: realized 
peermusic: peermusic 
version: versions version 
built: built 
eatin: eatin 
moonlight: moonlight 
heartfelt: heartfelt 
ironik: ironik 
david: david 
megan: megan 
egg: egg eggs 
wistful: wistful 
loved: loved 
zoe: zoe 
exhausting: exhausting 
goulding: goulding 
bullshit: bullshit 
terry: terry 
welling: welling 
sported: sported 
celebrity: celebrity 
haven: havens 
anybody: anybody 
gott: gott 
malice: malice 
redwood: redwood 
remembering: remembering 
tomando: tomando 
pride: pride 
person: person 
burn: burns burn 
misfit: misfits 
runnin: runnin 
imagination: imagination 
eight: eight 
spear: spears 
drown: drown 
streisand: streisand 
prone: prone 
roch: roch 
bobby: bobby 
jocelyn: jocelyn 
news: news 
dejes: dejes 
em: em 
hajacos: hajacos 
noah: noah 
bellas: bellas 
behold: behold 
el: el 
utah: utah 
incinerator: incinerator 
aileen: aileen 
corp: corps corp 
blow: blow 
klenord: klenord 
typical: typical 
breath: breath 
signature: signature 
october: october 
jonathan: jonathan 
okun: okun 
morris: morris 
pay: pay 
town: towns town 
settled: settled 
row: row 
kyoto: kyoto 
whimsical: whimsical 
gap: gap 
jensen: jensen 
chair: chair 
veil: veil 
anna: anna 
cope: cope 
runner: runner 
dej: dej 
exum: exum 
privateer: privateers 
idle: idle 
commenting: commenting 
bebida: bebida 
mcbride: mcbride 
pilgrim: pilgrims 
luvi: luvi 
booty: booty 
icu: icu 
smiled: smiled 
mist: mist 
damage: damage 
frequent: frequent 
deja: deja 
sasha: sasha 
reveal: reveal 
godbey: godbey 
ali: ali 
happens: happens 
pacing: pacing 
sexy: sexy 
flaming: flaming 
gossip: gossip 
ca: ca 
putaclic: putaclic 
classmate: classmate 
laughin: laughin 
raphael: raphael 
sorority: sorority 
slurring: slurring 
congressman: congressmen 
bungalow: bungalow 
mine: mine 
wha: wha 
reptilelegityt: reptilelegityt 
yudai: yudai 
beehive: beehive 
curtaine: curtaine 
ally: ally 
alcohol: alcohol 
marsh: marsh 
knapp: knapp 
romanian: romanian 
lewis: lewis 
girlfriend: girlfriend 
o: os 
tear: tears tear 
poop: poop 
clearly: clearly 
reburn: reburn 
buying: buying 
even: even 
sa: sa 
asylum: asylum 
divine: divine 
unclear: unclear 
universal: universal 
fondest: fondest 
kelsy: kelsy 
c: c 
text: text 
school: school schools 
hollens: hollens 
saben: saben 
clear: clear 
overdramatic: overdramatic 
betrayal: betrayal 
beside: beside 
residence: residence 
jeremy: jeremy 
george: george 
clayderman: clayderman 
gray: gray 
hosen: hosen 
taxi: taxi 
britney: britney 
hustling: hustling 
made: made 
tribute: tribute 
romanticizes: romanticizes 
rapper: rapper 
chart: charts chart 
scarf: scarf 
lose: lose 
tractor: tractors tractor 
garrett: garrett 
octoling: octoling 
nightmare: nightmares nightmare 
midwxst: midwxst 
whitley: whitley 
vera: vera 
sounding: sounding 
located: located 
inutilismo: inutilismo 
allovers: allovers 
destructo: destructo 
dying: dying 
cry: crying cry 
mdma: mdma 
class: class 
drink: drink 
announcing: announcing 
pittaluga: pittaluga 
dancin: dancin 
brian: brian 
yelled: yelled 
spoken: spoken 
honesty: honesty 
stoner: stoner 
bug: bug 
tire: tires 
shit: shit 
stuckey: stuckey 
dino: dino 
elliott: elliott 
betrayed: betrayed 
upbeat: upbeat 
st: st 
rotary: rotary 
dorothy: dorothy 
atlanta: atlanta 
nicer: nicer 
mode: mode 
army: army 
kirsten: kirsten 
iv: iv 
strung: strung 
baynton: baynton 
captainsparklez: captainsparklez 
heartbreak: heartbreak 
obsessive: obsessive 
mindy: mindy 
auceking: auceking 
hollis: hollis 
llevarlo: llevarlo 
immediately: immediately 
falling: falling 
mash: mash 
ferguson: ferguson 
understands: understands 
insane: insane 
lucido: lucido 
revive: revive 
weeping: weeping 
mill: mills 
common: common 
website: website 
cochran: cochran 
taylorswift: taylorswift 
parody: parody parodys 
eric: eric 
aj: aj 
organ: organ 
notgrass: notgrass 
mollin: mollin 
vintastic: vintastic 
trombone: trombone 
estaba: estaba 
fail: fail 
annabeth: annabeth 
ladder: ladder 
techno: techno 
direction: direction 
expert: expert 
comic: comics 
edmonton: edmonton 
fn: fn 
vb: vb 
soar: soars 
entire: entire 
heavily: heavily 
coat: coat 
ftly: ftly 
leaker: leakers 
finishing: finishing 
clapton: clapton 
heroin: heroin 
lack: lack 
expect: expect 
table: table 
bebe: bebe 
rime: rimes 
existed: existed 
incandescent: incandescent 
making: making 
herzog: herzog 
many: many 
jukebox: jukebox 
norsk: norsk 
brass: brass 
libbing: libbing 
punisher: punisher 
demolition: demolition 
conor: conor 
lemonade: lemonade 
hilliker: hilliker 
cap: cap 
parkwood: parkwood 
chevrolet: chevrolet 
activist: activist 
norrie: norrie 
door: door doors 
scenario: scenario 
blackmore: blackmore 
franklin: franklin 
special: special 
lovesick: lovesick 
cardigan: cardigan 
spectrum: spectrum 
jizz: jizz 
wagnerville: wagnerville 
speculate: speculate 
alternate: alternate 
triple: triple 
resonator: resonator 
lucky: lucky 
mouridsen: mouridsen 
dancer: dancer 
blew: blew 
gym: gym 
camp: camp camps 
imagined: imagined 
dig: dig 
reply: replies 
august: august 
interest: interest 
biggayrapper: biggayrapper 
spike: spike 
hospital: hospital 
higher: higher 
lista: lista 
terabrite: terabrite 
belin: belin 
declan: declan 
pitched: pitched 
agua: agua 
crowd: crowd crowds 
rus: russ 
linen: linen 
centerpiece: centerpiece 
header: headers 
chug: chug 
pulling: pulling 
mountain: mountain mountains 
stuffed: stuffed 
northern: northern 
dolores: dolores 
wow: wow 
panic: panic 
putting: putting 
gomez: gomez 
reminds: reminds 
match: match matches 
sleeping: sleeping 
copperhead: copperhead 
artista: artista 
molotov: molotov 
tongue: tongue 
vicarpi: vicarpi 
cave: cave 
phonographic: phonographic 
bettin: bettin 
mooney: mooney 
palmer: palmer 
tras: tras 
host: host 
swindled: swindled 
timberlake: timberlake 
enough: enough 
rabenold: rabenold 
nicholas: nicholas 
zollenkopf: zollenkopf 
bosch: bosch 
faithful: faithful 
deshannon: deshannon 
veronica: veronica 
amatsuka: amatsuka 
milik: milik 
vale: vale 
near: near 
cream: cream 
solely: solely 
enterprise: enterprises 
center: center 
lee: lee 
instrumental: instrumental 
europe: europe 
krause: krause 
hypha: hypha 
subdued: subdued 
populace: populace 
cambiando: cambiando 
como: como 
coe: coe 
sparse: sparse 
oddest: oddest 
turned: turned 
miller: miller 
imagining: imagining 
mago: mago 
drawn: drawn 
popular: popular 
crossword: crossword 
drowzee: drowzee 
winter: winter 
grossman: grossman 
eve: eve 
admiration: admiration 
thinking: thinking 
battle: battle 
af: af 
tight: tight 
jimi: jimi 
gilmore: gilmore 
eloisa: eloisa 
found: found 
reminded: reminded 
hidden: hidden 
wool: wool 
real: real 
pas: pass 
popularity: popularity 
recommended: recommended 
razavi: razavi 
suite: suite 
different: different 
niebank: niebank 
historia: historia 
guard: guards 
coyne: coyne 
tagalog: tagalog 
logo: logo 
edits: edits 
client: clients 
dennis: dennis 
break: break breaks 
payne: payne 
awakens: awakens 
backed: backed 
pappalardo: pappalardo 
talking: talking 
jag: jags 
gill: gill 
cheetos: cheetos 
quebec: quebec 
voicenote: voicenote 
bizarre: bizarre 
clovis: clovis 
stent: stent 
carved: carved 
count: count 
fantasy: fantasy 
rothschild: rothschild 
bitter: bitter 
lesley: lesley 
phillips: phillips 
written: written 
ronnie: ronnie 
case: case 
legendary: legendary 
protective: protective 
vivo: vivo 
signed: signed 
catching: catching 
hearing: hearing 
disfrutar: disfrutar 
raccoon: raccoon 
steiner: steiner 
lacy: lacy 
highlight: highlight 
worsnop: worsnop 
interlude: interlude 
lendon: lendon 
fairly: fairly 
contrast: contrast 
revolved: revolved 
plugger: pluggers 
arthur: arthur 
googlygoodgaming: googlygoodgaming 
tamerlane: tamerlane 
hartos: hartos 
untouchable: untouchable 
paint: paint 
needy: needy 
vitriolic: vitriolic 
battered: battered 
ducky: ducky 
columbia: columbia 
report: reports 
childlike: childlike 
suggests: suggests 
think: thinks think 
distant: distant 
malfatto: malfatto 
amas: amas 
remorse: remorse 
romanek: romanek 
nona: nona 
laughter: laughter 
melua: melua 
danger: danger 
sermon: sermon 
quiero: quiero 
distributor: distributor 
whirl: whirl 
jajai: jajai 
suzie: suzie 
zant: zant 
quickly: quickly 
wraith: wraith 
egerton: egerton 
kindly: kindly 
commonly: commonly 
mo: mo 
dystopian: dystopian 
gentleman: gentlemen 
inequality: inequality 
zbieral: zbieral 
unrepentant: unrepentant 
pivoting: pivoting 
hager: hager 
butch: butch 
swivel: swivel 
bread: bread 
adult: adult 
bruthur: bruthur 
viridiana: viridiana 
anthology: anthology 
screaming: screaming 
trout: trout 
reminisces: reminisces 
blouse: blouses 
lindsey: lindsey 
yank: yank 
ctc: ctc 
oelhrich: oelhrich 
danny: danny 
sigh: sigh 
use: use 
stoic: stoic 
youtube: youtube 
auburn: auburn 
fuckin: fuckin 
advil: advil 
lying: lying 
treacherous: treacherous 
splinter: splinter 
squaredance: squaredance 
otf: otf 
archibald: archibald 
contractual: contractual 
hayley: hayley 
stripe: stripes 
infatuation: infatuation 
gudwin: gudwin 
vanished: vanished 
doin: doin 
mcelderry: mcelderry 
ur: ur 
capaldi: capaldi 
influenced: influenced 
bromberg: bromberg 
maureen: maureen 
intestine: intestines 
shore: shore 
vecchio: vecchio 
kenyon: kenyon 
result: result 
beanpole: beanpole 
glad: glad 
chew: chew 
alive: alive 
clover: clover 
annotationas: annotationas 
bts: bts 
ellie: ellie 
slide: slide 
wlpwr: wlpwr 
design: design 
itunes: itunes 
taz: taz 
sadie: sadie 
crain: crain 
alyssa: alyssa 
hillary: hillary 
subwoolfer: subwoolfer 
healy: healy 
kin: kin 
bordone: bordone 
massive: massive 
tpn: tpns 
penas: penas 
unveiled: unveiled 
agree: agree 
hablando: hablando 
drummond: drummond 
antonia: antonia 
bhasker: bhasker 
baby: baby babies 
ando: ando 
must: must 
malcolm: malcolm 
shaking: shaking 
convince: convince 
large: large 
sinkin: sinkin 
motivation: motivation 
condescending: condescending 
highwater: highwater 
respond: respond 
mattered: mattered 
collect: collect 
mccartney: mccartney 
nocando: nocando 
regina: regina 
graham: graham 
swim: swims 
buford: buford 
stranded: stranded 
unotheactivist: unotheactivist 
dansk: dansk 
dessner: dessner 
alpenkracher: alpenkracher 
duty: duty 
screenwriter: screenwriter 
cruel: cruel 
jamee: jamee 
normal: normal 
chce: chce 
poor: poor 
dishrag: dishrag 
mega: mega 
tie: tie 
faking: faking 
served: served 
utsc: utsc 
potential: potential 
legend: legend 
aise: aise 
conniff: conniff 
rough: rough 
brillo: brillo 
bash: bash 
similarity: similarities 
dispute: disputes 
wish: wish wishes 
hop: hop 
fest: fest 
teller: teller 
unfaithful: unfaithful 
treble: treble 
ricochet: ricochet 
sea: seas sea 
slightly: slightly 
umaczenie: umaczenie 
livinho: livinho 
neighbour: neighbour 
referred: referred 
regrettable: regrettable 
walmart: walmart 
unofficial: unofficial 
xli: xli 
tiktok: tiktok 
ch: ch 
mirrorball: mirrorball 
tent: tent 
hobo: hobo 
cause: causes cause 
lady: ladies lady 
pad: pads 
isa: isa 
fp: fp 
self: self 
ob: ob 
international: international 
andrea: andrea 
rexha: rexha 
uzi: uzi 
fallen: fallen 
olvidarte: olvidarte 
mention: mention mentions 
four: four 
galland: galland 
karma: karma 
kamen: kamen 
bell: bells bell 
brooklyn: brooklyn 
gotta: gotta 
harris: harris 
chemay: chemay 
defines: defines 
decided: decided 
kobe: kobe 
moorer: moorer 
bonanza: bonanza 
tmz: tmz 
apparently: apparently 
nobody: nobody 
stoppin: stoppin 
ronstadt: ronstadt 
makeup: makeup 
wear: wear wears 
backyard: backyard 
hightower: hightower 
amra: amra 
ern: ern 
evolution: evolution 
push: push 
smokie: smokie 
either: either 
shame: shame 
beatdown: beatdown 
derek: derek 
fidelity: fidelity 
claim: claim 
shared: shared 
extending: extending 
insecure: insecure 
ensemble: ensemble 
gunstveit: gunstveit 
midwinter: midwinter 
relates: relates 
angry: angry 
moses: moses 
existing: existing 
blasko: blasko 
allowed: allowed 
vietnam: vietnam 
killxaki: killxaki 
cure: cure 
hawaii: hawaii 
realize: realize 
vagos: vagos 
levitz: levitz 
apparition: apparitions 
combine: combines 
never: never 
heed: heed 
little: little 
temecula: temecula 
bus: bus 
pluffaduff: pluffaduff 
singin: singin 
dermot: dermot 
pausini: pausini 
seoul: seoul 
flo: flo 
swiss: swiss 
rely: rely 
boulevard: boulevard 
cameron: cameron 
indroducing: indroducing 
lo: lo 
jot: jot 
spirit: spirit spirits 
hero: hero 
lifted: lifted 
toast: toast 
dust: dust 
branch: branch 
beyonc: beyonc 
ill: ill 
turning: turning 
choppa: choppa 
waylon: waylon 
witchy: witchy 
gabby: gabby 
plant: plant 
laughed: laughed 
eighth: eighth 
workin: workin 
esque: esque 
teased: teased 
tumay: tumay 
mining: mining 
minecraft: minecraft 
texture: texture 
protect: protect 
este: este 
lauer: lauer 
italiane: italiane 
another: another 
tilley: tilley 
pawn: pawn 
phifer: phifer 
cheeky: cheeky 
mexicano: mexicano 
passionate: passionate 
backlogged: backlogged 
wednesday: wednesday 
thread: thread 
butcher: butcher 
shifting: shifting 
willin: willin 
blackalicious: blackalicious 
dough: dough 
flattered: flattered 
tempted: tempted 
hugged: hugged 
checkin: checkin 
rent: rent 
cypher: cypher 
monday: monday 
dubstep: dubstep 
developed: developed 
wolverine: wolverine 
stuff: stuff 
path: path 
est: est 
enjoying: enjoying 
visit: visit 
chaos: chaos 
half: half 
tryhardninja: tryhardninja 
meme: meme memes 
tubbie: tubbie 
perfume: perfume 
jonny: jonny 
limb: limbs 
rocketman: rocketman 
variant: variant 
pasar: pasar 
left: left 
closing: closing 
sampson: sampson 
pioneer: pioneers 
involved: involved 
soft: soft 
uphill: uphill 
keleigh: keleigh 
magical: magical 
men: men 
juntarnos: juntarnos 
farsi: farsi 
osure: osure 
jottap: jottap 
brandi: brandi 
risky: risky 
sd: sd 
carlito: carlito 
correct: correct 
willdowdsy: willdowdsy 
blingin: blingin 
relayed: relayed 
mess: messes mess 
sew: sew 
jo: jo 
romanized: romanized 
meditation: meditation 
crush: crush 
cheating: cheating 
garcia: garcia 
ante: ante 
admitted: admitted 
fernanda: fernanda 
cool: cool 
well: well wells 
parado: parado 
kilgore: kilgore 
guet: guet 
carretera: carretera 
cilie: cilie 
arrival: arrival 
active: active 
ensamble: ensamble 
grasso: grasso 
republic: republic 
frame: frame 
tyminski: tyminski 
icarus: icarus 
percy: percy 
siguen: siguen 
head: heads head 
rhythmic: rhythmic 
helping: helping 
elevated: elevated 
laced: laced 
fancy: fancy 
tia: tia 
nightingale: nightingale 
upside: upside 
boost: boost 
synth: synth 
doorway: doorway 
knee: knees 
laptop: laptop 
bonnie: bonnie 
produce: produce 
gerry: gerry 
ok: ok 
widely: widely 
rabbit: rabbit 
listless: listless 
dustin: dustin 
twist: twist 
yes: yes 
austria: austria 
tokenblackygoguy: tokenblackygoguy 
chess: chess 
calmer: calmer 
bravest: bravest 
combined: combined 
coding: coding 
guthrie: guthrie 
benzel: benzel 
game: games game 
lucas: lucas 
remark: remarks 
inspiring: inspiring 
saloon: saloon 
gashi: gashi 
opal: opal 
edward: edwards 
generally: generally 
portugal: portugal 
symphonic: symphonic 
tend: tend 
presumably: presumably 
soil: soil 
sawed: sawed 
finna: finna 
confronts: confronts 
curve: curves curve 
una: una 
querida: querida 
colder: colder 
jackson: jackson 
ya: ya 
coolest: coolest 
apocalypse: apocalypse 
do: dos 
forget: forget 
prerogative: prerogative 
lunchin: lunchin 
love: loves love 
wrong: wrong 
ralph: ralph 
connection: connection 
cocktail: cocktail 
glistened: glistened 
yeet: yeet 
million: million millions 
dariacore: dariacore 
cooper: cooper 
flyingkitty: flyingkitty 
tattooine: tattooine 
calmly: calmly 
secrecy: secrecy 
krall: krall 
else: else 
er: er 
dodged: dodged 
killval: killval 
canadiana: canadiana 
rivera: rivera 
crossover: crossover 
abbey: abbey 
kimani: kimani 
filled: filled 
tiene: tiene 
sailor: sailor 
rodney: rodney 
darius: darius 
spit: spit 
stagger: staggers 
faceplants: faceplants 
organic: organic 
christ: christ 
beastie: beastie 
needing: needing 
gatorthelegend: gatorthelegend 
vin: vin 
chest: chest 
menestrel: menestrel 
npobu: npobu 
lookin: lookin 
flashing: flashing 
pounder: pounders 
pretender: pretenders 
extremely: extremely 
uniform: uniforms 
watched: watched 
surprisingly: surprisingly 
piggy: piggies piggy 
time: time times 
socialize: socialize 
iverson: iverson 
merrill: merrill 
video: videos video 
flaw: flaw 
schultz: schultz 
paso: paso 
mingo: mingo 
halifax: halifax 
tuesday: tuesday 
castle: castle 
clown: clown 
jumping: jumping 
sean: sean 
yahoo: yahoo 
belly: belly 
ni: ni 
zinger: zinger 
engineer: engineer 
truffle: truffle 
shown: shown 
budokan: budokan 
memorial: memorial 
everybody: everybody 
exclusively: exclusively 
writer: writer writers 
saw: saw 
leann: leann 
clean: clean 
jackhoeting: jackhoeting 
breakup: breakup 
acordarme: acordarme 
teddy: teddy 
hhb: hhb 
benmont: benmont 
iman: iman 
violette: violette 
swore: swore 
presiones: presiones 
email: email 
princess: princess 
transformation: transformation 
chip: chip 
former: former 
health: health 
jenn: jenn 
pokemon: pokemon 
throw: throw 
essig: essig 
perform: perform 
dreamed: dreamed 
fine: fine 
brittany: brittany 
dog: dogs dog 
scandipop: scandipop 
magnificently: magnificently 
tennis: tennis 
mandering: mandering 
front: front 
illness: illness 
handsome: handsome 
rich: rich 
im: im 
emi: emi 
g: g 
interpolation: interpolations 
meisner: meisner 
conductor: conductor 
wanna: wanna 
vu: vu 
no: nos 
clearwater: clearwater 
georgia: georgia 
hound: hound 
callmekevin: callmekevin 
fm: fm 
feminism: feminism 
lofgren: lofgren 
courtney: courtney 
gavin: gavin 
quarterhead: quarterhead 
champlin: champlin 
committee: committee 
slime: slime 
neal: neal 
paris: paris 
gallo: gallo 
lighting: lighting 
climbing: climbing 
maki: maki 
ryan: ryan 
dawn: dawn 
awoke: awoke 
suddenly: suddenly 
performed: performed 
garden: garden gardens 
moon: moon 
concise: concise 
pretty: pretty 
conviction: conviction 
daddy: daddy 
gecewicz: gecewicz 
specifically: specifically 
sub: sub 
grow: grow 
failing: failing 
triste: triste 
posted: posted 
seventy: seventies 
knechtel: knechtel 
scooter: scooter 
burg: burg 
offered: offered 
tito: tito 
swimmer: swimmer 
power: power 
raise: raise 
intrude: intrude 
hablo: hablo 
iphone: iphone 
murs: murs 
bethesda: bethesda 
estoy: estoy 
dior: dior 
dudgeon: dudgeon 
warned: warned 
dad: dad 
bragg: bragg 
cyrus: cyrus 
collage: collage 
acceptance: acceptance 
tammy: tammy 
thus: thus 
guilty: guilty 
jiorgi: jiorgi 
unklesounds: unklesounds 
ignore: ignore 
brustofski: brustofski 
revealed: revealed 
matty: matty 
doghouse: doghouse 
carve: carve 
perhaps: perhaps 
trisha: trisha 
colt: colt 
wedding: wedding 
relief: relief 
spite: spite 
dano: dano 
nothin: nothin 
issue: issue issues 
marque: marque 
maggie: maggie 
remotely: remotely 
sher: sher 
dylan: dylan 
nose: nose 
carte: cartes 
wonderfully: wonderfully 
mista: mista 
aqua: aqua 
caring: caring 
peaked: peaked 
tell: tell tells 
rick: rick 
jennings: jennings 
stephan: stephan 
much: much 
watt: watts watt 
bittersweet: bittersweet 
greta: greta 
bennett: bennett 
wilson: wilson 
russell: russell 
addition: addition 
prioritize: prioritize 
quaye: quaye 
submarine: submarine 
brings: brings 
shopping: shopping 
sloop: sloop 
admin: admin 
ronson: ronson 
alaina: alaina 
kurstin: kurstin 
counterpart: counterpart 
helm: helm 
harbour: harbour 
amos: amos 
bentleys: bentleys 
xo: xo 
rodrigo: rodrigo 
cotton: cotton 
apr: aprs 
martin: martin 
inhibition: inhibitions 
ditty: ditty 
farther: farther 
puedo: puedo 
evil: evil 
belief: believes belief 
pato: pato 
olvidemos: olvidemos 
carried: carried 
wrapped: wrapped 
chari: charis 
produced: produced 
crossed: crossed 
brenda: brenda 
counted: counted 
yaminobahamut: yaminobahamut 
gated: gated 
cimorelli: cimorelli 
lyrically: lyrically 
latinautor: latinautor 
caf: caf 
hoffman: hoffman 
alleged: alleged 
danjahandz: danjahandz 
xxl: xxl 
midnite: midnite 
intensity: intensity 
pebble: pebbles 
contains: contains 
snow: snow 
called: called 
olly: olly 
chelsom: chelsom 
slay: slay 
evening: evening 
boat: boat 
kutch: kutch 
richaadeb: richaadeb 
orbison: orbison 
retro: retro 
stokes: stokes 
avoid: avoid 
truth: truth 
brewer: brewer 
google: google 
brief: brief briefs 
blacklynk: blacklynk 
bart: bart 
stoned: stoned 
sprayed: sprayed 
careless: careless 
toleration: toleration 
dude: dude 
statler: statler 
eastern: eastern 
every: every 
smash: smash 
mint: mint 
cinema: cinema 
excited: excited 
fu: fu 
burning: burning 
overheard: overheard 
tragos: tragos 
oversettelse: oversettelse 
washington: washington 
bright: bright 
unique: unique 
whatever: whatever 
choice: choice 
tangled: tangled 
replaced: replaced 
mixed: mixed 
dreamer: dreamers 
synthesizer: synthesizer 
debuted: debuted 
pringle: pringle 
molina: molina 
danoff: danoff 
fuess: fuess 
speaking: speaking 
desktop: desktop 
zydeco: zydeco 
scrud: scrud 
qualified: qualified 
muddy: muddy 
nuance: nuances 
block: block 
slavery: slavery 
repita: repita 
patrick: patrick 
fearless: fearless 
devotion: devotion 
itswolfplayz: itswolfplayz 
pretending: pretending 
drop: drop 
priority: priority 
rowdy: rowdy 
nicole: nicole 
music: music 
gish: gish 
danubia: danubia 
nikki: nikki 
extent: extent 
vedder: vedder 
redekopp: redekopp 
breathe: breathe 
whip: whip 
paisley: paisley 
explained: explained 
salem: salem 
byu: byu 
heartbreaking: heartbreaking 
killing: killing 
shofu: shofu 
lean: lean 
instagram: instagram 
joint: joint 
visiting: visiting 
actor: actor actors 
pivotal: pivotal 
troy: troy 
westlife: westlife 
perez: perez 
seemed: seemed 
ode: ode 
noob: noob 
ep: ep 
scarlet: scarlet 
daymanoursavior: daymanoursavior 
bagsy: bagsy 
avicii: avicii 
instant: instant 
windmark: windmark 
chore: chores 
freak: freaks 
pier: pier 
naim: naim 
jacob: jacobs 
nineteen: nineteen 
grc: grc 
amounted: amounted 
trouble: trouble 
clarified: clarified 
dated: dated 
developing: developing 
evanson: evanson 
impersonated: impersonated 
charmed: charmed 
booby: boobies 
long: long 
da: da 
mitchell: mitchell 
pulse: pulse 
reason: reasons reason 
diverse: diverse 
june: june 
hobbs: hobbs 
kyle: kyle 
flatts: flatts 
crypt: crypt 
sp: sp 
brighter: brighter 
phil: phil 
paid: paid 
fortnite: fortnite 
tha: tha 
fraser: fraser 
bop: bop 
foreign: foreign 
over: overs 
composer: composer 
integral: integral 
fgl: fgl 
pair: pair 
mary: mary 
barber: barber 
p: p 
unnamed: unnamed 
biff: biff 
krivchenia: krivchenia 
exact: exact 
direct: direct 
everyman: everyman 
hurry: hurry 
taupin: taupin 
slave: slave 
dlt: dlt 
carri: carri 
shania: shania 
verbatim: verbatim 
sinclair: sinclair 
paak: paak 
cherry: cherry 
entitled: entitled 
sake: sake 
president: president 
pink: pink 
accent: accent 
dia: dia 
previous: previous 
multiplayer: multiplayer 
magee: magee 
gimme: gimme 
bedroom: bedroom 
edt: edt 
director: director 
roger: roger 
daybyday: daybyday 
absolutely: absolutely 
kori: kori 
lightbody: lightbody 
rockabilly: rockabilly 
settlement: settlement 
bucket: bucket 
came: came 
clayton: clayton 
skipping: skipping 
annotation: annotation 
johnson: johnson 
loaded: loaded 
buried: buried 
term: terms 
warns: warns 
black: black 
pressing: pressing 
kim: kim 
cleaning: cleaning 
com: com 
cadillac: cadillac 
rave: rave 
cline: cline 
norah: norah 
gator: gators 
connect: connect 
anyhow: anyhow 
malouf: malouf 
entertains: entertains 
check: check 
kitty: kitty 
ditto: ditto 
laura: laura 
rpg: rpg 
embracing: embracing 
busbee: busbee 
redd: redd 
lars: lars 
razor: razor 
backyardigans: backyardigans 
reportedly: reportedly 
noticed: noticed 
deluded: deluded 
augustine: augustine 
fired: fired 
cinco: cinco 
hint: hint 
jd: jd 
searching: searching 
twitter: twitter 
casey: casey 
sitting: sitting 
broadway: broadway 
selection: selection 
yudkin: yudkin 
boyce: boyce 
cheated: cheated 
alameen: alameen 
sobre: sobre 
cincoyo: cincoyo 
mon: mon 
lift: lifts 
innocent: innocent 
amateur: amateur 
ine: ine 
pawel: pawel 
apologizing: apologizing 
receiving: receiving 
port: port 
east: east 
go: goes go 
bad: bad 
ohno: ohno 
meeting: meeting 
let: let 
traducciones: traducciones 
switch: switch 
retroactively: retroactively 
dial: dial 
rant: rant 
sutcliffe: sutcliffe 
donnell: donnell 
rxad: rxad 
ctrl: ctrl 
fool: fool 
griffith: griffith 
yocum: yocum 
favorite: favorite 
restless: restless 
cheap: cheap 
aun: aun 
booked: booked 
gig: gig 
tomorrow: tomorrow 
daria: daria 
lyin: lyin 
muy: muy 
doo: doo 
zach: zach 
hill: hills hill 
alabamy: alabamy 
suppose: suppose 
snap: snap 
overdubs: overdubs 
relic: relic 
crazy: crazy 
goodman: goodman 
heartland: heartland 
hey: hey 
selling: selling 
vibe: vibe vibes 
changin: changin 
kidz: kidz 
kaitlynn: kaitlynn 
expected: expected 
mormon: mormons 
elegie: elegie 
hoe: hoes hoe 
triunfo: triunfo 
aggressive: aggressive 
vivian: vivian 
vo: vo 
populaire: populaire 
bio: bio 
ny: ny 
florence: florence 
mmmmm: mmmmm 
eretz: eretz 
codeine: codeine 
amendment: amendment 
emergency: emergency 
recognizes: recognizes 
farthing: farthing 
drunk: drunk 
sent: sent 
drawer: drawer 
recognize: recognize 
seventh: seventh 
crib: crib 
svensk: svensk 
typo: typo 
morning: mornings morning 
till: till 
dedboii: dedboii 
plenty: plenty 
nickelback: nickelback 
sonically: sonically 
harmony: harmonies harmony 
bandipat: bandipat 
instead: instead 
ev: ev 
eddie: eddie 
doveman: doveman 
watchin: watchin 
emotionally: emotionally 
slap: slap 
thakkar: thakkar 
guess: guess 
makin: makin 
cock: cock 
thanos: thanos 
revisited: revisited 
fluid: fluid 
emily: emily 
pin: pin 
liquor: liquor 
persian: persian 
whatcha: whatcha 
headtaps: headtaps 
progressive: progressive 
ephiphany: ephiphany 
noise: noise 
streaming: streaming 
fruity: fruity 
geoff: geoff 
marjorie: marjorie 
recurrent: recurrent 
itis: itis 
aah: aah 
lasting: lasting 
guyzzz: guyzzz 
barbra: barbra 
misconstrue: misconstrue 
orchestral: orchestral 
riksm: riksm 
figured: figured 
cape: cape 
learn: learn 
numerous: numerous 
waitin: waitin 
locked: locked 
lark: lark 
concord: concord 
conway: conway 
ivy: ivy 
labeled: labeled 
cabin: cabin 
businessmen: businessmen 
as: ass 
bother: bother 
overshadows: overshadows 
sell: sell 
lil: lil 
glance: glance 
sapphire: sapphire 
astralphaser: astralphaser 
nicolle: nicolle 
realises: realises 
tomlin: tomlin 
memory: memory memories 
trauma: trauma 
collaborashawn: collaborashawn 
cupcakke: cupcakke 
querer: querer 
opinion: opinion 
kiedy: kiedy 
sized: sized 
vert: vert 
schipa: schipa 
good: good 
stump: stump 
shlomo: shlomo 
shortly: shortly 
marquez: marquez 
burgh: burgh 
glover: glover 
sat: sat 
okay: okay 
imagine: imagine 
flute: flute 
itzy: itzy 
phoebe: phoebe 
racer: racer 
oakland: oakland 
dillon: dillon 
pickup: pickup 
bos: boss 
cabello: cabello 
swan: swan 
camila: camila 
pack: pack 
wight: wight 
damn: damn 
unfolded: unfolded 
shane: shane 
pasco: pasco 
chatting: chatting 
excavating: excavating 
unapologetic: unapologetic 
alestorm: alestorm 
kaufman: kaufman 
instantly: instantly 
affair: affair affairs 
awakening: awakening 
hawk: hawk 
caitlin: caitlin 
harrison: harrison 
plagiarized: plagiarized 
sick: sick 
abusing: abusing 
isaiah: isaiah 
davi: davi 
mrozinski: mrozinski 
cemented: cemented 
aging: aging 
alpha: alpha 
nolan: nolan 
impact: impact 
strike: strike 
torture: tortures 
tumble: tumble 
mothafucka: mothafucka 
patricia: patricia 
caravan: caravan 
option: option options 
conjunction: conjunction 
jitterbug: jitterbug 
impossible: impossible 
lange: lange 
textbook: textbook 
ondara: ondara 
editor: editor 
ironically: ironically 
toshinskiy: toshinskiy 
athens: athens 
programmed: programmed 
gutman: gutman 
along: along 
venice: venice 
wyclef: wyclef 
saviano: saviano 
rewritten: rewritten 
country: countries country 
positive: positive 
skrrt: skrrt 
loana: loana 
aura: aura 
extends: extends 
endure: endure 
refuse: refuses 
culture: culture 
amusing: amusing 
cage: cage 
hunt: hunt 
charly: charly 
lone: lone 
bleacher: bleachers 
instrumentation: instrumentation 
bryce: bryce 
thorn: thorns 
swing: swing 
goddess: goddess 
ambo: ambos 
blomerati: blomerati 
harding: harding 
ben: ben 
joey: joey 
prince: princes prince 
yacht: yacht 
eyed: eyed 
vece: vece 
whitehouse: whitehouse 
amount: amount 
taffy: taffy 
rainwater: rainwater 
hashtag: hashtag 
conflicting: conflicting 
doodle: doodle 
fruto: fruto 
cousin: cousins 
stereophonics: stereophonics 
ethiopian: ethiopians 
colin: colin 
lowe: lowe 
bunch: bunch 
adversity: adversities 
publicist: publicists 
continuity: continuity 
eso: eso 
madeleine: madeleine 
emotion: emotion emotions 
stained: stained 
marshall: marshall 
vanderbilt: vanderbilt 
connie: connie 
throwing: throwing 
adrianna: adrianna 
shameless: shameless 
load: load 
ference: ference 
regardless: regardless 
scandinavia: scandinavia 
personality: personality 
leib: leib 
gretchen: gretchen 
easy: easy 
business: business 
lordy: lordy 
nearly: nearly 
speaks: speaks 
join: join 
blood: blood 
male: male 
conveys: conveys 
tritt: tritt 
selena: selena 
heel: heels 
gonorrhea: gonorrhea 
adjective: adjectives adjective 
barrett: barrett 
dozen: dozen 
swindler: swindlers 
boyfriend: boyfriend 
bathroom: bathroom 
euro: euro 
three: three 
denzel: denzel 
riddleberger: riddleberger 
pennsylvania: pennsylvania 
sever: sever 
april: april 
collapsed: collapsed 
reynolds: reynolds 
thunberg: thunberg 
unborn: unborn 
decent: decent 
uptight: uptight 
enter: enter 
portraying: portraying 
necessity: necessity 
follows: follows 
rua: rua 
teardrop: teardrop 
foresee: foresee 
waltzy: waltzy 
contributed: contributed 
guldemond: guldemond 
jim: jim 
label: label labels 
toe: toe 
generation: generation 
order: order 
drag: drag 
contained: contained 
lokeigh: lokeigh 
nd: nd 
writin: writin 
filipino: filipino 
finisher: finisher 
donovan: donovan 
intervention: intervention 
trapper: trapper 
opium: opium 
acknowledges: acknowledges 
fall: falls fall 
noggin: noggin 
pray: pray 
smith: smith 
breaking: breaking 
stapleton: stapleton 
possible: possible 
padre: padres 
brilliant: brilliant 
faux: faux 
chemical: chemical 
duncan: duncan 
square: square 
therealsullyg: therealsullyg 
adventurous: adventurous 
enemy: enemy 
sammy: sammy 
human: human 
size: size 
surprise: surprise 
hurt: hurt 
nostalgia: nostalgia 
cryin: cryin 
rutherford: rutherford 
erin: erin 
breakin: breakin 
watergate: watergate 
similar: similar 
butterfly: butterfly butterflies 
veloso: veloso 
intricate: intricate 
inflicted: inflicted 
romero: romero 
ticket: tickets ticket 
barrel: barrel 
reacting: reacting 
whistle: whistle 
clifton: clifton 
omarcameup: omarcameup 
cove: cove 
carolina: carolina 
licensing: licensing 
sentimental: sentimental 
carmen: carmen 
rose: rose 
phased: phased 
jayesslee: jayesslee 
refers: refers 
anyways: anyways 
guerilla: guerilla 
huett: huett 
figuratively: figuratively 
starting: starting 
matti: matti 
curse: curse 
shooter: shooter 
ela: ela 
oedipal: oedipal 
sara: sara 
prod: prod 
rhythm: rhythm 
mullan: mullan 
hubbard: hubbard 
context: context 
nuclear: nuclear 
cardboard: cardboard 
vincent: vincent 
diggy: diggy 
institution: institutions 
khaled: khaled 
gang: gang 
jul: jul 
jagger: jagger 
zerzil: zerzil 
verso: verso 
pronounced: pronounced 
preacher: preacher 
schwizzle: schwizzle 
featuring: featuring 
kreed: kreed 
powerful: powerful 
russian: russian 
searchin: searchin 
alabama: alabama 
stupid: stupid 
wore: wore 
ethan: ethan 
szab: szab 
spent: spent 
adrenaline: adrenaline 
stephen: stephen 
lea: lea 
ladao: ladao 
playful: playful 
complete: complete 
milkshake: milkshake 
combo: combo 
colvin: colvin 
reprise: reprise 
gardner: gardner 
brand: brands brand 
fnf: fnf 
worked: worked 
aesthetic: aesthetic 
dejar: dejar 
rumoured: rumoured 
oooh: oooh 
purpose: purpose 
palpable: palpable 
actual: actual 
perfomance: perfomance 
pero: pero 
screen: screen 
lobby: lobby 
ranch: ranch 
pac: pac 
laughing: laughing 
delight: delight 
park: park 
poem: poem poems 
boxer: boxer 
exist: exist 
olhou: olhou 
claire: claire 
thanks: thanks 
swamp: swamp 
en: en 
motion: motion 
expression: expressions 
dedicates: dedicates 
shiki: shiki 
super: super 
burnett: burnett 
phrase: phrases 
israel: israel 
clarinet: clarinet 
silver: silver 
garth: garth 
lamentation: lamentations 
devendorf: devendorf 
sutton: sutton 
whitford: whitford 
fucked: fucked 
syndicated: syndicated 
louder: louder 
rex: rex 
jewel: jewel 
kingfish: kingfish 
known: known 
increase: increase 
kream: kream 
anything: anything 
cello: cello 
sinning: sinning 
truly: truly 
yungmanny: yungmanny 
tryin: tryin 
galactic: galactic 
schulz: schulz 
checotah: checotah 
stefanie: stefanie 
mccrary: mccrary 
choir: choir 
barker: barker 
brasil: brasil 
indirectly: indirectly 
vuelvo: vuelvo 
haunted: haunted 
meant: meant 
bersetzung: bersetzung 
december: december 
heroine: heroines 
frisky: frisky 
sincere: sincere 
crosson: crosson 
added: added 
slumerican: slumerican 
ndez: ndez 
alison: alison 
bear: bear 
zain: zain 
chose: chose 
night: nights night 
sevendust: sevendust 
jmp: jmp 
enchanced: enchanced 
maynelli: maynelli 
lied: lied 
satan: satan 
memorizing: memorizing 
svenska: svenska 
edmundson: edmundson 
chinese: chinese 
scottish: scottish 
temptation: temptations 
randall: randall 
belonging: belonging 
loretta: loretta 
mat: mat 
kagayakashiki: kagayakashiki 
danja: danja 
phillip: phillip 
abdullah: abdullah 
jenna: jenna 
stomping: stomping 
bring: bring 
ross: ross 
rise: rise 
seguramente: seguramente 
crept: crept 
wop: wop 
dio: dio 
fardalen: fardalen 
listened: listened 
traduction: traduction 
creativity: creativity 
tore: tore 
francis: francis 
article: article 
technology: technology 
net: net 
white: white 
confusion: confusion 
sinatra: sinatra 
kameron: kameron 
raced: raced 
ready: ready 
cheney: cheney 
role: role roles 
ektomorf: ektomorf 
vers: vers 
duane: duane 
rollin: rollin 
ttelse: ttelse 
coincidence: coincidences 
stu: stu 
horne: horne 
one: one ones 
underneath: underneath 
daytrip: daytrip 
prozz: prozz 
seen: seen 
etc: etc 
subject: subject 
mouth: mouth 
mtsg: mtsg 
bowed: bowed 
worker: workers 
house: house 
player: player 
qued: qued 
eleanora: eleanora 
fern: fern 
listen: listen 
loose: loose 
ranger: ranger 
widow: widow 
stomach: stomach 
assery: assery 
angeles: angeles 
gamers: gamers 
freezing: freezing 
hayward: hayward 
hayes: hayes 
shellback: shellback 
archer: archer 
necessarily: necessarily 
klondike: klondike 
interesting: interesting 
background: background 
deuce: deuce 
thomas: thomas 
tan: tan 
fly: fly 
snapped: snapped 
entertainment: entertainment 
theatre: theatre 
spiritual: spiritual 
mendes: mendes 
doorstep: doorstep 
splat: splat 
requires: requires 
harnen: harnen 
romantic: romantic 
abuse: abuse 
proibido: proibido 
wax: wax 
syllable: syllable 
musique: musique 
revival: revival 
hugger: huggers 
maynard: maynard 
gettin: gettin 
huff: huff 
forced: forced 
knelt: knelt 
conni: conni 
snippet: snippet 
ahhh: ahhh 
shotgun: shotgun 
sense: sense 
pre: pre 
responsibility: responsibilities 
ship: ship 
vision: vision 
nomnomnom: nomnomnom 
perfect: perfect 
plagiarize: plagiarize 
hay: hay 
jordan: jordan 
aventura: aventura 
jung: jung 
grows: grows 
wheeler: wheeler 
jab: jabs 
zealand: zealand 
fireside: fireside 
ah: ah 
recordz: recordz 
bob: bob 
daughtry: daughtry 
asking: asking 
florida: florida 
maim: maim 
agust: agust 
opening: opening 
experimental: experimental 
myles: myles 
burnham: burnham 
accusatory: accusatory 
calma: calma 
rol: rol 
upon: upon 
sensibility: sensibility 
farewell: farewell 
associate: associates 
ignorin: ignorin 
attempted: attempted 
controversy: controversy 
alvaro: alvaro 
tag: tags 
bmi: bmi 
cicierega: cicierega 
exemplifies: exemplifies 
acclaimed: acclaimed 
allie: allie 
walt: walt 
grammy: grammy 
diversity: diversity 
audio: audio 
greenberg: greenberg 
bye: bye 
tanya: tanya 
demis: demis 
chiquis: chiquis 
blast: blast 
twelfth: twelfth 
pastiche: pastiche 
gunn: gunn 
confetti: confetti 
giey: giey 
volumeeventureslic: volumeeventureslic 
happy: happy 
guest: guest 
vertaling: vertaling 
performend: performend 
galaxy: galaxy 
lauren: lauren 
emlyn: emlyn 
kiwi: kiwi 
hittin: hittin 
jun: jun 
slastic: slastic 
henry: henry 
delivering: delivering 
persson: persson 
shoe: shoes 
sheep: sheep 
rocky: rocky 
moving: moving 
apocalyptic: apocalyptic 
nate: nate 
superstar: superstar 
miami: miami 
anne: anne 
z: z 
somethin: somethin 
twice: twice 
mentioned: mentioned 
katie: katie 
similarly: similarly 
fiery: fiery 
wifebeatmane: wifebeatmane 
fendi: fendi 
wondering: wondering 
italian: italian 
christina: christina 
bandmates: bandmates 
explaining: explaining 
gostou: gostou 
flipped: flipped 
cabrel: cabrel 
explains: explains 
nugget: nugget 
eddy: eddy 
ranked: ranked 
rowe: rowe 
danielle: danielle 
mcalister: mcalister 
chamber: chamber 
electronic: electronic 
glamorous: glamorous 
ninth: ninth 
gonna: gonna 
cheering: cheering 
postales: postales 
arizona: arizona 
stein: stein 
contact: contact 
hesitated: hesitated 
finding: finding 
hood: hood 
devil: devil 
dub: dub 
joseph: joseph 
jeffedyeffedy: jeffedyeffedy 
shelly: shelly 
roche: roche 
wesnizzle: wesnizzle 
simple: simple 
dou: dou 
peek: peek 
march: march 
safety: safety 
flirted: flirted 
witchcraft: witchcraft 
achieving: achieving 
chattanooga: chattanooga 
acquaintance: acquaintance 
hizo: hizo 
bribe: bribe 
mainly: mainly 
tezinho: tezinho 
wonder: wonder wonders 
crutch: crutch 
pl: pl 
sidoti: sidoti 
cont: cont 
banded: banded 
poster: poster 
recalled: recalled 
recovering: recovering 
lori: lori 
singh: singh 
cancer: cancer 
bosque: bosque 
zaccheus: zaccheus 
alejandra: alejandra 
seems: seems 
grandma: grandma 
opened: opened 
mesmerizing: mesmerizing 
thirteenth: thirteenth 
afterward: afterward 
rosined: rosined 
acre: acres 
rehab: rehab 
dried: dried 
associated: associated 
hmm: hmm 
palm: palm 
evan: evan 
fillmore: fillmore 
ramblin: ramblin 
nigga: nigga 
amazed: amazed 
shay: shay 
lullaby: lullaby 
blurry: blurry 
speak: speak 
chode: chode 
beneath: beneath 
carrying: carrying 
shed: shed 
debra: debra 
unless: unless 
personnel: personnel 
pensarte: pensarte 
finish: finish 
yeehaw: yeehaw 
manager: manager 
racoon: racoon 
crawling: crawling 
backroad: backroad 
graveyard: graveyard 
grieving: grieving 
jonestown: jonestown 
hard: hard 
activity: activities 
megamix: megamix 
save: save 
cappellino: cappellino 
writing: writing 
shoppin: shoppin 
cox: cox 
incident: incident 
herring: herring 
sok: sok 
everywhere: everywhere 
sporting: sporting 
eminem: eminem 
element: elements 
holophonics: holophonics 
dreamland: dreamland 
mekhi: mekhi 
armageddon: armageddon 
praise: praise 
false: false 
postmodern: postmodern 
cosmic: cosmic 
darken: darken 
gregory: gregory 
gotten: gotten 
hippy: hippies 
hugo: hugo 
narrative: narrative 
inez: inez 
leadon: leadon 
murph: murph 
tea: tea 
streetlight: streetlight 
pagan: pagan 
status: status 
declared: declared 
silverado: silverado 
stealing: stealing 
iconic: iconic 
jesse: jesse 
desperado: desperado 
consideration: consideration 
laa: laa 
savoy: savoy 
loudly: loudly 
chain: chain 
kerry: kerry 
chilling: chilling 
decade: decade 
wife: wife 
impetus: impetus 
johnny: johnny 
weepin: weepin 
depre: depre 
tonk: tonk 
barbarian: barbarian 
reveals: reveals 
hello: hello 
crowell: crowell 
faber: faber 
guide: guide 
freeman: freeman 
iheart: iheart 
formation: formation 
detailing: detailing 
aix: aix 
sport: sports 
aim: aim 
nichijou: nichijou 
nessly: nessly 
caption: caption 
ground: ground 
law: law 
honeybrowne: honeybrowne 
mixing: mixing 
sincerity: sincerity 
minuteman: minutemen 
j: j 
rorp: rorp 
carpenter: carpenter 
topic: topics 
hollered: hollered 
introduction: introduction 
spanish: spanish 
cobblestone: cobblestones 
chuck: chuck 
opera: opera 
legacy: legacy 
edit: edit 
internet: internet 
wrenching: wrenching 
aunque: aunque 
goodnight: goodnight 
ultimately: ultimately 
compas: compas 
imprisoned: imprisoned 
jayrick: jayrick 
haze: haze 
alphamega: alphamega 
millionaire: millionaire 
strictly: strictly 
moi: moi 
drove: drove 
sickly: sickly 
moracchioli: moracchioli 
nom: nom 
fui: fui 
kear: kear 
pueda: pueda 
anymore: anymore 
wardrobe: wardrobe 
cancelled: cancelled 
pale: pale 
zac: zac 
smyers: smyers 
suggesting: suggesting 
quiet: quiet 
garc: garc 
vein: veins 
backpack: backpack 
accidentally: accidentally 
colorado: colorado 
annuity: annuity 
charlton: charlton 
bronco: broncos 
thrives: thrives 
bosanski: bosanski 
yelawolf: yelawolf 
schram: schram 
oban: oban 
january: january 
dooroo: dooroo 
nurse: nurses 
quentin: quentin 
culbertson: culbertson 
releasing: releasing 
clint: clint 
injury: injury 
de: de 
sex: sex 
desperate: desperate 
panini: panini 
touching: touching 
floating: floating 
beerbongs: beerbongs 
maguire: maguire 
spoke: spoke 
manic: manic 
mendoza: mendoza 
olinos: olinos 
su: su 
julia: julia 
mcanally: mcanally 
eylands: eylands 
paramor: paramor 
climb: climb 
con: con 
cecilia: cecilia 
weird: weird 
lola: lola 
pan: pan 
nuptials: nuptials 
moriondo: moriondo 
graduation: graduation 
upcoming: upcoming 
simone: simone 
mcculler: mcculler 
landevei: landevei 
mikael: mikael 
extended: extended 
vemos: vemos 
escrib: escrib 
remains: remains 
goostavo: goostavo 
hoping: hoping 
thrown: thrown 
oliver: oliver 
translated: translated 
pocket: pocket pockets 
license: license 
zoo: zoos 
anywhere: anywhere 
poo: poo 
olivia: olivia 
martha: martha 
headlining: headlining 
sought: sought 
rucka: rucka 
upchurch: upchurch 
silkiewicz: silkiewicz 
tic: tic 
weight: weight 
naked: naked 
christxphvr: christxphvr 
gorgeous: gorgeous 
gimmes: gimmes 
indeed: indeed 
wilkeson: wilkeson 
cellular: cellular 
female: female 
includes: includes 
jamaica: jamaica 
camel: camels 
ser: ser 
ay: ay 
prisi: prisi 
maxine: maxine 
seguidores: seguidores 
bakersfield: bakersfield 
fred: fred 
passing: passing 
ooh: ooh 
draggin: draggin 
louis: louis 
formally: formally 
yer: yer 
gunshot: gunshot 
twitch: twitch 
honor: honor 
niall: niall 
optimist: optimist 
hedge: hedges 
shoal: shoals 
sens: senses 
portrait: portrait 
versi: versi 
control: control 
bextor: bextor 
resultado: resultado 
sleep: sleep sleeps 
joensen: joensen 
slava: slava 
yandere: yandere 
norby: norby 
nev: nev 
savannah: savannah 
shipley: shipley 
celebrating: celebrating 
entirely: entirely 
diagnosed: diagnosed 
ing: ing 
stanknasty: stanknasty 
someone: someone 
least: least 
triangle: triangle 
ahuevo: ahuevo 
scratch: scratch 
closely: closely 
sinneyy: sinneyy 
flying: flying 
uni: uni 
glen: glen 
circumstance: circumstances 
cow: cows 
willshire: willshire 
calm: calm 
royce: royce 
toy: toy 
edition: edition 
dalai: dalai 
pare: pare 
minnesota: minnesota 
niner: niner 
parable: parable 
paul: paul 
first: first 
closest: closest 
appeared: appeared 
phenix: phenix 
titanic: titanic 
lifetime: lifetime 
odkyle: odkyle 
darcy: darcy 
shoppe: shoppe 
maine: maines 
forever: forever 
musgraves: musgraves 
chrissie: chrissie 
reflect: reflect 
contesto: contesto 
bates: bates 
twine: twine 
bold: bold 
kick: kick 
illustrating: illustrating 
redditor: redditor 
yareed: yareed 
transplant: transplants 
een: een 
microphone: microphone 
kvety: kvety 
slit: slit 
passenger: passenger 
advertise: advertise 
groom: groom 
yippee: yippee 
stall: stalls 
creedence: creedence 
effect: effect 
suffer: suffer 
motivated: motivated 
ficos: ficos 
starter: starter 
brien: brien 
horrible: horrible 
approval: approval 
chitty: chitty 
gil: gil 
tourist: tourist 
rain: rain 
prominently: prominently 
hearted: hearted 
manipulative: manipulative 
kusorare: kusorare 
danced: danced 
tinder: tinder 
approach: approaches approach 
account: account 
pitch: pitch 
fatal: fatal 
saxophone: saxophone 
sugar: sugar 
melt: melt 
hungover: hungover 
mistaken: mistaken 
dwelt: dwelt 
resemblance: resemblance 
suit: suit 
texas: texas 
punishment: punishment 
diego: diego 
jerry: jerry 
robertson: robertson 
superar: superar 
default: default 
wrestling: wrestling 
ops: ops 
harmonium: harmonium 
mirror: mirror 
dean: dean 
hattie: hattie 
fromtheheart: fromtheheart 
wide: wide 
link: link 
slipped: slipped 
milton: milton 
kurt: kurt 
dreadful: dreadful 
pedigree: pedigree 
twisted: twisted 
hell: hell 
takin: takin 
reinaeiry: reinaeiry 
dewtie: dewtie 
cheese: cheese 
tragedy: tragedy 
polaris: polaris 
gaga: gaga 
luscious: luscious 
calf: calves 
mx: mx 
belt: belt 
bowery: bowery 
stroke: stroke 
ceo: ceo 
notably: notably 
mann: manns 
wonderful: wonderful 
pardison: pardison 
dixie: dixie 
drifter: drifter 
newton: newton 
kelly: kelly 
tool: tools 
vfx: vfx 
bruise: bruise 
sixer: sixer 
audience: audience 
individual: individual 
humperdinck: humperdinck 
bran: bran 
sit: sit 
translate: translate 
clearance: clearance 
bouzouki: bouzouki 
arrested: arrested 
west: west 
disco: disco 
partner: partner 
presley: presley 
armadillo: armadillo 
paper: paper 
atheist: atheist 
galyon: galyon 
believin: believin 
soundslikepizza: soundslikepizza 
keith: keith 
growing: growing 
originated: originated 
naturally: naturally 
ambivalent: ambivalent 
plotted: plotted 
planeta: planeta 
turnpike: turnpike 
pop: pop 
loop: loop 
provides: provides 
mercedes: mercedes 
plaid: plaid 
drank: drank 
accolade: accolades 
wallen: wallen 
starlight: starlight 
sahara: sahara 
sturgill: sturgill 
pinchers: pinchers 
wtf: wtf 
awarded: awarded 
amazon: amazon 
nederlandse: nederlandse 
shuetube: shuetube 
blame: blame 
morey: morey 
information: information 
ritter: ritter 
personified: personified 
face: face 
noodle: noodle 
anonymuz: anonymuz 
cupid: cupid 
wherever: wherever 
dierks: dierks 
notoriety: notoriety 
simultaneously: simultaneously 
ellrod: ellrod 
mothered: mothered 
complication: complication 
pillow: pillow 
cothran: cothran 
alfred: alfred 
mcentire: mcentire 
skeleton: skeletons 
porch: porch 
spab: spab 
somebody: somebody 
clay: clay 
preceded: preceded 
protracted: protracted 
llegar: llegar 
commercial: commercial 
cindy: cindy 
saved: saved 
slatt: slatt 
teenage: teenage 
phyllotaxis: phyllotaxis 
wishing: wishing 
tedder: tedder 
given: given 
trippie: trippie 
marching: marching 
biggie: biggie 
anderson: anderson 
amzing: amzing 
gyllenhaal: gyllenhaal 
keb: keb 
osborne: osborne 
scrap: scrap 
scienceos: scienceos 
mca: mca 
bookend: bookend 
fairweather: fairweather 
lonnie: lonnie 
metrosexuals: metrosexuals 
aug: aug 
lively: lively 
rida: rida 
chapter: chapter 
liar: liar 
awhile: awhile 
honey: honey 
jolene: jolene 
denis: denis 
inner: inner 
american: american 
calling: calling 
overheated: overheated 
dive: dive 
contract: contract 
sheer: sheer 
nine: nine 
doc: doc 
lemonheads: lemonheads 
sparkling: sparkling 
comedy: comedy 
willow: willow 
cost: cost 
airport: airport 
offset: offsets 
arlovol: arlovol 
hi: hi 
seated: seated 
stylistically: stylistically 
dirt: dirt 
hennie: hennie 
prudence: prudence 
ronan: ronan 
length: length 
eladio: eladio 
duff: duff 
ounce: ounce 
pirate: pirate 
boondocks: boondocks 
stephanie: stephanie 
gerrard: gerrard 
kinder: kinder 
unreviewed: unreviewed 
extra: extra 
dee: dee 
morgan: morgan 
felipe: felipe 
suspected: suspected 
alamo: alamo 
coale: coale 
dick: dick 
ye: ye 
dabbling: dabbling 
shelton: shelton 
animada: animada 
joel: joel 
threw: threw 
cassidy: cassidy 
harder: harder 
headed: headed 
tragic: tragic 
prized: prized 
thick: thick 
evulva: evulva 
compulsive: compulsive 
massey: massey 
biograph: biograph 
compliment: compliment 
feminist: feminist 
schmidt: schmidt 
mall: mall 
italiano: italiano 
tying: tying 
dicho: dicho 
tupelo: tupelo 
retrospectiva: retrospectiva 
battery: battery 
shootout: shootout 
triggering: triggering 
trilemma: trilemma 
flock: flock 
anger: anger 
diligently: diligently 
apologetix: apologetix 
sorrow: sorrow 
great: great 
nonstop: nonstop 
consumerism: consumerism 
siendo: siendo 
cole: cole 
esta: esta 
stated: stated 
hutchinson: hutchinson 
lael: lael 
crespo: crespo 
shanty: shanty 
igual: igual 
monte: montes 
mississippi: mississippi 
wedder: wedder 
ajenos: ajenos 
willies: willies 
sack: sacks 
lauv: lauv 
taxxon: taxxon 
autumn: autumn 
melodic: melodic 
bruised: bruised 
luv: luv 
shalom: shalom 
iu: iu 
member: member 
aligned: aligned 
kennedy: kennedy 
eighteen: eighteen 
blackyspeakz: blackyspeakz 
condition: condition conditions 
addiction: addiction 
saturday: saturday 
cam: cam 
autonomy: autonomy 
trophy: trophies 
grocery: grocery 
snake: snake 
collaborate: collaborate 
eleventh: eleventh 
