morrison: morrison 
la: la 
deehousemf: deehousemf 
bukovac: bukovac 
go: go 
interpolate: interpolate 
lucky: lucky 
interpolation: interpolations 
ground: ground 
created: created 
transcriber: transcribers 
sagittarius: sagittarius 
echo: echoes 
charlie: charlie 
flying: flying 
knowing: knowing 
throwback: throwback 
side: side 
red: red 
engineer: engineer 
date: date 
traducciones: traducciones 
mixing: mixing 
q: q 
v: v 
recording: recording 
later: later 
release: release 
portugu: portugu 
dark: dark 
street: street 
personal: personal 
daring: daring 
twin: twin 
spanish: spanish 
home: home 
received: received 
ilya: ilya 
type: type 
huff: huff 
tom: tom 
promotional: promotional 
sample: sample samples 
jeanne: jeanne 
losing: losing 
share: share 
g: g 
strong: strong 
line: lines 
sad: sad 
never: never 
bit: bit 
love: love 
two: two 
griffith: griffith 
actor: actor 
tell: tell 
fifth: fifth 
trouble: trouble 
cover: cover covers 
synthesizer: synthesizer 
expand: expand 
relationship: relationship relationships 
alone: alone 
suddenly: suddenly 
e: es e 
yudkin: yudkin 
tag: tags 
z: z 
somebody: somebody 
known: known 
mind: mind 
starlight: starlight 
wilson: wilson 
always: always 
thinking: thinking 
brasil: brasil 
bold: bold 
view: view 
compare: compares 
cause: cause 
biggest: biggest 
anger: anger 
loop: loop 
gotta: gotta 
breakdown: breakdown 
privacy: privacy 
italic: italics 
u: us u 
light: lights 
digital: digital 
right: right 
pop: pop 
maserati: maserati 
header: headers 
current: current 
information: information 
espa: espa 
guideline: guidelines 
stay: stay 
contributor: contributor contributors 
affection: affection 
even: even 
head: head 
part: parts part 
understand: understand 
livy: livy 
read: read 
w: w 
cimorelli: cimorelli 
also: also 
ever: ever 
lee: lee 
toshinskiy: toshinskiy 
songwriter: songwriter 
drum: drums 
em: em 
together: together 
track: track 
know: know 
maddie: maddie 
steel: steel 
performance: performances 
bollman: bollman 
country: country 
everything: everything 
believed: believed 
upright: upright 
milik: milik 
lose: lose 
credit: credits 
percussion: percussion 
chorus: chorus 
musical: musical 
insight: insight 
tragic: tragic 
bass: bass 
end: end 
anthem: anthem 
faster: faster 
source: source 
jason: jason 
sin: sin 
certification: certifications 
ana: ana 
term: terms 
felt: felt 
bouzouki: bouzouki 
official: official 
copyright: copyright 
r: r 
outro: outro 
coordinator: coordinator 
knowledge: knowledge 
fighting: fighting 
verified: verified 
certified: certified 
correlating: correlating 
visit: visit 
platinum: platinum 
great: great 
sell: sell 
production: production 
year: year 
l: l 
moment: moment 
gallo: gallo 
mash: mash 
david: david 
new: new 
missing: missing 
mastering: mastering 
developer: developers 
taylor: taylor 
passion: passion 
spinning: spinning 
hidden: hidden 
come: comes come 
frog: frog 
al: al 
french: french 
color: colors 
solve: solve 
press: press 
chapman: chapman 
almost: almost 
studio: studios 
generally: generally 
acoustic: acoustic 
well: well 
arcade: arcade 
state: state 
seth: seth 
shop: shop 
jealousy: jealousy 
gyllenhaal: gyllenhaal 
dead: dead 
blackbird: blackbird 
easy: easy 
burning: burning 
format: format 
section: section 
regretting: regretting 
last: last 
ml: ml 
niebank: niebank 
back: back 
already: already 
treacherous: treacherous 
moving: moving 
post: post 
aaron: aaron 
campbell: campbell 
world: world 
paul: paul 
title: title 
crime: crime 
found: found 
ol: ol 
nicole: nicole 
yeah: yeah 
n: n 
ending: ending 
lyric: lyric lyrics 
sloas: sloas 
j: j 
duduzinho: duduzinho 
vh: vh 
artist: artists 
portuguese: portuguese 
single: single 
marcantonio: marcantonio 
inspiration: inspiration 
vida: vida 
embed: embed 
holding: holdings 
viva: viva 
transcription: transcription 
job: jobs 
wish: wish 
answer: answer 
learn: learn 
album: album 
holy: holy 
label: label 
need: need 
gray: gray 
record: records 
version: version 
advertise: advertise 
oh: oh 
call: call 
f: f 
riaa: riaa 
message: message 
assistant: assistant 
individual: individual 
mike: mike 
dann: dann 
ultimate: ultimate 
alex: alex 
driving: driving 
spectrum: spectrum 
song: songs song 
skateboard: skateboard 
front: front 
live: live 
licensing: licensing 
could: could 
begin: begin 
changed: changed 
music: music 
contact: contact 
big: big 
lia: lia 
round: round 
guitar: guitar 
nathan: nathan 
mc: mc 
organ: organ 
collection: collection 
tradu: tradu 
franklin: franklin 
bright: bright 
pro: pro 
hot: hot 
change: change 
said: said 
one: one 
old: old 
annotation: annotation 
released: released 
thing: thing 
video: videos 
traducci: traducci 
p: p 
add: add 
check: check 
machine: machine 
space: space 
sag: sag 
sign: sign 
passionate: passionate 
favorite: favorite 
let: let 
since: since 
october: october 
k: k 
demo: demo 
might: might 
cupid: cupid 
featured: featured 
comment: comment comments 
swift: swift 
judge: judge 
ask: ask 
alexi: alexi 
met: met 
autumn: autumn 
grace: grace 
emma: emma 
free: free 
drop: drop 
wind: wind 
touching: touching 
morton: morton 
flashback: flashbacks 
blue: blue 
editing: editing 
crossword: crossword 
forgetting: forgetting 
remembering: remembering 
h: h 
loving: loving 
itzy: itzy 
c: c 
originally: originally 
realizing: realizing 
guide: guide 
translation: translation translations 
still: still 
wishing: wishing 
zodiac: zodiac 
justin: justin 
different: different 
feeling: feelings 
bridge: bridge 
original: original 
promote: promote 
scholar: scholars 
deluxe: deluxe 
forum: forum 
alpine: alpine 
distinguish: distinguish 
steve: steve 
drew: drew 
policy: policy 
storyteller: storytellers 
verse: verse 
fall: fall 
etc: etc 
hank: hank 
peach: peaches 
getting: getting 
goot: goot 
rock: rock 
whoa: whoa 
jimmie: jimmie 
trying: trying 
ft: ft 
beautiful: beautiful 
use: use 
fact: facts 
frustration: frustration 
memorizing: memorizing 
vocalist: vocalists 
question: question 
best: best 
like: like 
broken: broken 
written: written 
singer: singer 
genius: genius 
b: b 
emulation: emulation 
recorded: recorded 
knew: knew 
repeating: repeating 
ganjo: ganjo 
possible: possible 
time: time 
x: x 
medley: medley 
writing: writing 
piano: piano 
harmony: harmony 
went: went 
worst: worst 
williams: williams 
wanted: wanted 
televised: televised 
chart: charts 
girl: girl 
sterling: sterling 
jonathan: jonathan 
cancel: cancel 
produced: produced 
llc: llc 
jake: jake 
interpreted: interpreted 
emotion: emotions 
impossible: impossible 
see: see 
word: words 
