la: la 
yaminobahamut: yaminobahamut 
go: go 
chappell: chappell 
leaving: leaving 
interpolate: interpolate 
baby: baby 
desktop: desktop 
nine: nine 
interpolation: interpolations 
created: created 
transcriber: transcribers 
spent: spent 
thurl: thurl 
apple: apple 
champlin: champlin 
kanye: kanye 
donut: donuts 
spite: spite 
animated: animated 
featuring: featuring 
thrown: thrown 
google: google 
ian: ian 
charles: charles 
lie: lie 
match: match 
california: california 
ross: ross 
designer: designer 
therealsullyg: therealsullyg 
start: start 
jennings: jennings 
roadtrip: roadtrip 
rich: rich 
sunnageronimo: sunnageronimo 
mashup: mashup 
ridin: ridin 
king: king 
engineer: engineer 
date: date 
gw: gw 
mixing: mixing 
q: q 
rap: rap 
hope: hope 
cheese: cheese 
genre: genre 
v: v 
recording: recording 
huge: huge 
release: release 
later: later 
anything: anything 
atticus: atticus 
want: want 
tractor: tractor 
personal: personal 
twin: twin 
spanish: spanish 
hologram: holograms 
miche: miche 
joe: joe 
home: home 
record: record records 
received: received 
iv: iv 
iii: iii 
otr: otr 
type: type 
people: people 
catherine: catherine 
taken: taken 
porch: porch 
hit: hit hits 
sample: sample samples 
james: james 
otamatone: otamatone 
kobalt: kobalt 
santo: santo 
share: share 
traductions: traductions 
making: making 
carretera: carretera 
panini: panini 
g: g 
kick: kick 
line: lines line 
na: nas 
vocal: vocal vocals 
flyingkitty: flyingkitty 
love: love 
life: life 
two: two 
wait: wait 
farmer: farmer 
tell: tell 
cover: cover covers 
got: got 
expand: expand 
listening: listening 
pluffaduff: pluffaduff 
vieja: vieja 
refrain: refrain 
get: get 
cmrra: cmrra 
link: link 
whip: whip 
ron: ron 
tag: tags 
inch: inch 
aidan: aidan 
z: z 
thanos: thanos 
house: house 
session: session 
remixes: remixes 
demoned: demoned 
breakout: breakout 
sport: sports 
grc: grc 
cross: cross 
young: young 
minute: minutes minute 
always: always 
leo: leo 
bold: bold 
microsoft: microsoft 
management: management 
kurt: kurt 
view: view 
dick: dick 
green: green 
sony: sony 
co: co 
matte: matte 
aise: aise 
porsche: porsche 
sparked: sparked 
tracy: tracy 
thug: thug 
dragonas: dragonas 
biggest: biggest 
booby: boobies 
doodle: doodle 
privacy: privacy 
italic: italics 
u: us u 
ai: ais aises 
bring: bring 
happy: happy 
diamond: diamond diamonds 
matt: matt 
walkin: walkin 
tucker: tucker 
bala: bala 
right: right rights 
tezinho: tezinho 
pop: pop 
maserati: maserati 
header: headers 
button: buttons 
trist: trist 
information: information 
guideline: guidelines 
jj: jj 
tack: tack 
nick: nick 
road: road roads 
distributor: distributor 
man: man 
contributor: contributor contributors 
vert: vert 
even: even 
surprise: surprise 
yung: yung 
mpa: mpa 
sound: sound 
part: parts part 
understand: understand 
read: read 
first: first 
w: w 
also: also 
editor: editor 
postmodern: postmodern 
day: day 
background: background 
wanna: wanna 
trap: trap 
brokeback: brokeback 
established: established 
together: together 
ankojem: ankojem 
glove: glove 
code: code 
track: track 
performance: performances performance 
country: country 
schramm: schramm 
publishing: publishing 
ghost: ghosts 
cena: cena 
zollenkopf: zollenkopf 
everything: everything 
helfant: helfant 
instalok: instalok 
credit: credits 
chorus: chorus 
nd: nd 
bts: bts 
melissa: melissa 
musical: musical 
ubem: ubem 
angelica: angelica 
dove: dove 
walk: walk 
insight: insight 
chris: chris 
score: score 
mcbride: mcbride 
hoe: hoe 
billboard: billboard 
source: source 
control: control 
ryan: ryan 
react: react 
certification: certifications 
parody: parody 
ride: ride 
qualified: qualified 
meme: memes meme 
younce: younce 
uzi: uzi 
term: terms 
felt: felt 
eladio: eladio 
bando: bando 
farsi: farsi 
hugo: hugo 
alt: alt 
copyright: copyright 
r: r 
knowledge: knowledge 
christian: christian 
photography: photography 
devin: devin 
gonna: gonna 
verified: verified 
visit: visit 
great: great 
sell: sell 
production: production 
executive: executive 
l: l 
search: search 
casey: casey 
aguiar: aguiar 
lot: lot 
dlt: dlt 
black: black 
david: david 
ramsey: ramsey 
new: new 
gaa: gaa 
collective: collective 
mastering: mastering 
submarine: submarine 
felp: felp 
livin: livin 
developer: developers 
cowboy: cowboy 
madilyn: madilyn 
levitz: levitz 
compliment: compliment 
come: comes come 
think: think 
abramus: abramus 
rodeo: rodeo 
french: french 
group: group 
animada: animada 
mean: means 
town: towns town 
press: press 
turkish: turkish 
removal: removal 
studio: studios studio 
acoustic: acoustic 
mega: mega 
earth: earth 
enlists: enlists 
amazing: amazing 
lane: lane 
state: state 
shop: shop 
gold: gold 
kerry: kerry 
respect: respect 
vega: vega 
barefoot: barefoot 
going: going 
nothin: nothin 
grammy: grammy 
stick: stick 
mason: mason 
aligned: aligned 
dead: dead 
blow: blow 
sonique: sonique 
rave: rave 
osure: osure 
attached: attached 
format: format 
grasso: grasso 
section: section 
negro: negro 
taking: taking 
reznor: reznor 
ml: ml 
last: last 
forever: forever 
kevdog: kevdog 
back: back 
lil: lil 
los: los 
calmatic: calmatic 
trem: trem 
hultquist: hultquist 
ha: ha 
decide: decide 
world: world 
tryhardninja: tryhardninja 
band: band 
yeah: yeah 
n: n 
oof: oof 
stone: stone 
lyric: lyric lyrics 
j: j 
seeing: seeing 
portuguese: portuguese 
support: support 
theatre: theatre 
artist: artists 
fran: fran 
thought: thought 
til: til 
started: started 
larsen: larsen 
awakens: awakens 
candice: candice 
huey: huey 
embed: embed 
holding: holdings 
sio: sio 
transcription: transcription 
job: jobs 
watching: watching 
art: art 
bbc: bbc 
wish: wish 
answer: answer 
learn: learn 
fp: fp 
horse: horse horses 
solar: solar 
scott: scott 
jukebox: jukebox 
gay: gay 
cage: cage 
youngkio: youngkio 
ray: ray 
label: label 
kevin: kevin 
twitter: twitter 
metal: metal 
version: version 
advertise: advertise 
commentary: commentary 
oh: oh 
hood: hood 
felipe: felipe 
sings: sings 
smash: smash 
f: f 
cheney: cheney 
columbia: columbia 
leahy: leahy 
twisted: twisted 
riaa: riaa 
traduction: traduction 
hip: hip 
west: west 
carri: carri 
boot: boots 
make: make 
e: e 
edward: edwards 
ireland: ireland 
lagg: lagg 
wesnizzle: wesnizzle 
latinautor: latinautor 
saul: saul 
individual: individual 
mike: mike 
away: away 
phonographic: phonographic 
ultimate: ultimate 
director: director 
welcome: welcome 
jon: jon 
tarnation: tarnation 
moracchioli: moracchioli 
song: songs song 
okay: okay 
take: take 
burka: burka 
performed: performed 
sun: sun 
habit: habit 
live: live 
kio: kio 
rockstar: rockstar 
saying: saying 
licensing: licensing 
costume: costumes 
minecraft: minecraft 
could: could 
songview: songview 
hahn: hahn 
music: music 
key: key 
active: active 
contact: contact 
caravan: caravan 
itaru: itaru 
translate: translate 
richaadeb: richaadeb 
actually: actually 
guitar: guitar 
mc: mc 
run: run 
collection: collection 
least: least 
remix: remix 
retrospectiva: retrospectiva 
diplo: diplo 
hop: hop 
marie: marie 
cupcakke: cupcakke 
andrew: andrew 
nobody: nobody 
ekholm: ekholm 
hot: hot 
bright: bright 
united: united 
schneider: schneider 
victor: victor 
said: said 
de: de 
bryan: bryan 
fan: fan 
signed: signed 
marlboro: marlboro 
video: video videos 
old: old 
annotation: annotation 
atlanta: atlanta 
basically: basically 
final: final 
warner: warner 
braden: braden 
p: p 
earworm: earworm 
wrangler: wrangler 
made: made 
gigi: gigi 
probably: probably 
add: add 
check: check 
clown: clown 
sign: sign 
car: car 
series: series 
mile: miles 
jozzy: jozzy 
via: via 
interlude: interlude 
k: k 
might: might 
design: design 
cupid: cupid 
billy: billy 
previously: previously 
jordandropout: jordandropout 
featured: featured 
mily: mily 
outlawed: outlawed 
olhou: olhou 
comment: comment comments 
say: say 
dean: dean 
translated: translated 
ask: ask 
debate: debate 
angeles: angeles 
decade: decade 
mall: mall 
free: free 
drop: drop 
valley: valley 
butthepmo: butthepmo 
natewantstobattle: natewantstobattle 
closely: closely 
entertainment: entertainment 
reference: reference 
russian: russian 
movie: movie 
lean: lean 
bmi: bmi 
rescue: rescue 
kylie: kylie 
club: club 
universal: universal 
amra: amra 
accolade: accolades 
h: h 
cheated: cheated 
bradlee: bradlee 
three: three 
money: money 
c: c 
guide: guide 
translation: translation translations 
april: april 
still: still 
vfx: vfx 
electric: electric 
top: top 
intro: intro 
different: different 
short: short 
producer: producer 
mink: mink 
een: een 
publisher: publisher 
original: original 
promote: promote 
scholar: scholars 
forum: forum 
bull: bull 
whether: whether 
pedrinho: pedrinho 
distinguish: distinguish 
dan: dan 
gang: gang 
danish: danish 
policy: policy 
ela: ela 
noob: noob 
verse: verse 
etc: etc 
peach: peaches 
getting: getting 
influenced: influenced 
rock: rock 
moonie: moonies 
campa: campa 
eric: eric 
fendi: fendi 
bolooki: bolooki 
ft: ft 
brand: brand 
use: use 
dabbling: dabbling 
chicken: chicken 
trent: trent 
football: football 
vocalist: vocalists 
fact: facts 
cyrus: cyrus 
dj: dj 
question: question 
jones: jones 
usa: usa 
like: like 
ring: rings 
outlaw: outlaws 
broken: broken 
written: written 
something: something 
gucci: gucci 
lama: lama 
singer: singer 
southside: southside 
genius: genius 
b: b 
chart: chart charts 
stress: stress 
recorded: recorded 
repeating: repeating 
nail: nails 
year: years 
ascap: ascap 
literally: literally 
time: time 
x: x 
sam: sam 
medley: medley 
glish: glish 
captainsparklez: captainsparklez 
hat: hat 
plant: plant 
bra: bras 
castanhari: castanhari 
fourth: fourth 
girl: girl 
waylon: waylon 
every: every 
roll: roll 
feature: feature 
jonathan: jonathan 
night: night 
ctrl: ctrl 
cancel: cancel 
produced: produced 
bladder: bladder 
willdowdsy: willdowdsy 
llc: llc 
yocum: yocum 
ravenscroft: ravenscroft 
chinese: chinese 
john: john 
tsui: tsui 
star: stars 
award: awards 
cinco: cinco 
booty: booty 
nothing: nothing 
