ignored: ignored 
go: go 
created: created 
transcriber: transcribers 
fast: fast 
blurry: blurry 
meadow: meadows 
dress: dress 
mayer: mayer 
empty: empty 
statement: statement 
put: put 
date: date 
traducciones: traducciones 
q: q 
third: third 
v: v 
later: later 
release: release 
dark: dark 
anything: anything 
messed: messed 
want: want 
personal: personal 
tonight: tonight 
spanish: spanish 
twin: twin 
handle: handle 
optimism: optimism 
would: would 
home: home 
type: type 
people: people 
everyday: everyday 
speak: speak 
losing: losing 
mention: mention 
purposefully: purposefully 
orchestral: orchestral 
email: email 
share: share 
usually: usually 
whole: whole 
g: g 
line: lines line 
sad: sad 
never: never 
directly: directly 
love: love 
two: two 
life: life 
synthesizer: synthesizer 
expand: expand 
high: high 
paint: paint 
swore: swore 
relationship: relationship 
shared: shared 
venting: venting 
night: nights 
get: get 
issue: issue 
treated: treated 
gap: gap 
tag: tags 
fly: fly 
z: z 
known: known 
vulnerable: vulnerable 
mind: mind 
streak: streak 
mine: mine 
young: young 
wilson: wilson 
cried: cried 
always: always 
bold: bold 
reflection: reflection 
view: view 
cause: cause 
angel: angel 
biggest: biggest 
keeping: keeping 
firework: fireworks 
privacy: privacy 
girl: girls girl 
italic: italics 
u: us u 
happy: happy 
throughout: throughout 
wondering: wondering 
pop: pop 
sort: sort 
header: headers 
information: information 
gossip: gossip 
espa: espa 
game: games game 
guideline: guidelines 
else: else 
stay: stay 
person: person 
contributor: contributor contributors 
traitor: traitors 
send: send 
even: even 
warning: warnings 
part: parts part 
understand: understand 
read: read 
w: w 
also: also 
ever: ever 
background: background 
magazine: magazine 
songwriter: songwriter 
reaction: reaction 
list: list 
name: name 
seen: seen 
pickin: pickin 
track: track 
know: know 
performance: performances performance 
country: country 
grow: grow 
dry: dry 
everything: everything 
phone: phone 
credit: credits 
doll: doll 
percussion: percussion 
chorus: chorus 
musical: musical 
insight: insight 
bass: bass 
used: used 
blind: blind 
somewhere: somewhere 
obvious: obvious 
source: source 
long: long 
adult: adult 
term: terms 
skin: skin 
blame: blame 
multiple: multiple 
copyright: copyright 
r: r 
outro: outro 
knowledge: knowledge 
match: matches 
footstep: footsteps 
verified: verified 
visit: visit 
priority: priority 
sell: sell 
rule: rules 
dear: dear 
year: year years 
l: l 
search: search 
egomaniac: egomaniac 
haunted: haunted 
reply: replies 
heart: heart 
playing: playing 
revenge: revenge 
besides: besides 
sonically: sonically 
developer: developers 
taylor: taylor 
sutton: sutton 
presumptuous: presumptuous 
think: think 
al: al 
spark: sparks 
wrong: wrong 
press: press 
chapman: chapman 
well: well 
december: december 
public: public 
shop: shop 
eye: eyes 
going: going 
mother: mother 
format: format 
section: section 
ml: ml 
last: last 
back: back 
fellow: fellow 
conveys: conveys 
world: world 
paul: paul 
title: title 
ol: ol 
n: n 
added: added 
stone: stone 
maybe: maybe 
lyric: lyric lyrics 
th: th 
played: played 
fine: fine 
j: j 
artist: artists 
revolved: revolved 
counting: counting 
chess: chess 
embed: embed 
holding: holdings 
transcription: transcription 
job: jobs 
sky: sky 
answer: answer 
learn: learn 
emotional: emotional 
album: album 
far: far 
label: label 
need: need 
turn: turn 
record: records 
version: version 
advertise: advertise 
oh: oh 
hear: hear 
reference: references 
gone: gone 
f: f 
staying: staying 
twisted: twisted 
others: others 
keep: keep 
disregarded: disregarded 
fire: fire 
collaborated: collaborated 
wing: wings 
slurring: slurring 
e: e 
sorry: sorry 
individual: individual 
mike: mike 
away: away 
ultimate: ultimate 
mark: marks 
alex: alex 
instrumentals: instrumentals 
age: age 
putting: putting 
song: songs song 
take: take 
look: look 
tommy: tommy 
live: live 
saying: saying 
licensing: licensing 
could: could 
give: give 
changed: changed 
music: music 
contact: contact 
big: big 
guitar: guitar 
nathan: nathan 
innocent: innocent 
paper: paper 
mean: mean 
run: run 
collection: collection 
lifeless: lifeless 
sims: sims 
negative: negative 
website: website 
hot: hot 
change: change 
said: said 
bryan: bryan 
catch: catch 
expert: expert 
rain: rain 
annotation: annotation 
released: released 
took: took 
month: months 
traducci: traducci 
video: videos 
guess: guess 
p: p 
pushing: pushing 
add: add 
check: check 
including: including 
machine: machine 
sign: sign 
impressed: impressed 
ballad: ballads ballad 
let: let 
october: october 
rolling: rolling 
hole: hole 
k: k 
might: might 
beef: beef 
cupid: cupid 
featured: featured 
comment: comment comments 
swift: swift 
say: say 
ask: ask 
sidoti: sidoti 
notably: notably 
kind: kind 
around: around 
drop: drop 
rabbit: rabbit 
wrote: wrote 
darken: darken 
test: tests 
blue: blue 
write: write 
rescue: rescue 
lived: lived 
h: h 
shining: shining 
three: three 
c: c 
replied: replied 
better: better 
way: way 
guide: guide 
translation: translation translations 
nineteen: nineteen 
short: short 
different: different 
tired: tired 
good: good 
stopped: stopped 
feeling: feelings 
loved: loved 
bridge: bridge 
promote: promote 
scholar: scholars 
forum: forum 
distinguish: distinguish 
story: story 
grant: grant 
another: another 
kiss: kiss 
policy: policy 
verse: verse 
fall: fall 
etc: etc 
sick: sick 
glamour: glamour 
peach: peaches 
tim: tim 
someone: someone 
teen: teen 
rock: rock 
eric: eric 
desire: desire 
amos: amos 
acing: acing 
accused: accused 
half: half 
use: use 
fact: facts 
frustration: frustration 
vocalist: vocalists 
enchanted: enchanted 
question: question 
humiliated: humiliated 
like: like 
technique: technique 
day: days 
broken: broken 
written: written 
singer: singer 
ten: ten 
genius: genius 
b: b 
repeating: repeating 
heller: heller 
x: x 
floor: floor 
thick: thick 
went: went 
cover: covers 
regret: regret 
chart: charts 
contribute: contribute 
praying: praying 
cancel: cancel 
produced: produced 
llc: llc 
burned: burned 
mickelson: mickelson 
john: john 
developed: developed 
town: town 
really: really 
called: called 
contemporary: contemporary 
see: see 
