la: la 
go: go 
interpolate: interpolate 
oakland: oakland 
baby: baby 
ground: ground 
created: created 
transcriber: transcribers 
march: march 
ronnie: ronnie 
ward: ward 
envy: envy 
johnson: johnson 
charlie: charlie 
folk: folk 
frankie: frankie 
mi: mi 
dreamed: dreamed 
mayer: mayer 
bromberg: bromberg 
mccoy: mccoy 
dwarf: dwarf 
drink: drink 
remastering: remastering 
barbara: barbara 
graven: graven 
critic: critics 
devlin: devlin 
woman: women 
romero: romero 
indigo: indigo 
di: di 
engineer: engineer 
date: date 
mixing: mixing 
q: q 
servant: servants 
v: v 
recording: recording 
priest: priest 
huge: huge 
release: release 
personal: personal 
tonight: tonight 
customatrix: customatrix 
rutherford: rutherford 
airline: airlines 
twin: twin 
tape: tape 
record: record records 
wesley: wesley 
classic: classic 
type: type 
june: june 
tom: tom 
sample: sample samples 
vedder: vedder 
east: east 
lion: lion 
share: share 
pity: pity 
whole: whole 
mr: mr 
haute: haute 
g: g 
line: lines line 
love: love 
life: life 
two: two 
sixty: sixties 
cover: cover covers 
expand: expand 
byrne: byrne 
budokan: budokan 
night: nights 
get: get 
marching: marching 
tag: tags 
vietnam: vietnam 
affinity: affinity 
super: super 
z: z 
november: november 
blue: blues blue 
garcia: garcia 
jerry: jerry 
young: young 
cried: cried 
came: came 
always: always 
bold: bold 
watch: watch 
management: management 
view: view 
elli: ellis 
sony: sony 
francis: francis 
en: en 
biggest: biggest 
ferry: ferry 
plowman: plowmen 
privacy: privacy 
thief: thief 
girl: girls 
italic: italics 
u: us u 
happy: happy 
kept: kept 
prince: princes prince 
table: table 
cove: cove 
header: headers 
confusion: confusion 
skouras: skouras 
information: information 
guideline: guidelines 
prepare: prepare 
distributor: distributor 
contributor: contributor contributors 
didier: didier 
harding: harding 
gahr: gahr 
wicked: wicked 
common: common 
many: many 
even: even 
iamtidus: iamtidus 
watchman: watchman 
part: parts part 
understand: understand 
read: read 
w: w 
also: also 
hendrix: hendrix 
ever: ever 
landlord: landlord 
lee: lee 
deutsch: deutsch 
morning: morning 
songwriter: songwriter 
hedge: hedges 
drum: drums 
hour: hour 
track: track 
know: know 
messenger: messenger 
matthew: matthews 
performance: performances 
country: country 
publishing: publishing 
turned: turned 
shipley: shipley 
everything: everything 
st: st 
jr: jr 
credit: credits 
chorus: chorus 
musical: musical 
draco: draco 
insight: insight 
bass: bass 
chris: chris 
additional: additional 
juda: judas 
source: source 
emi: emi 
bowl: bowl 
knickerbocker: knickerbocker 
schipa: schipa 
hogni: hogni 
september: september 
falsely: falsely 
term: terms 
wight: wight 
charlton: charlton 
version: versions version 
fallen: fallen 
copyright: copyright 
r: r 
knowledge: knowledge 
photography: photography 
verified: verified 
behold: behold 
visit: visit 
dave: dave 
sell: sell 
must: must 
escape: escape 
fratellis: fratellis 
dear: dear 
production: production 
l: l 
search: search 
berg: berg 
ass: asses 
theory: theories 
bragg: bragg 
david: david 
new: new 
noted: noted 
greg: greg 
reason: reason 
guet: guet 
isle: isle 
developer: developers 
york: york 
du: du 
cbs: cbs 
thomas: thomas 
group: group 
adam: adams 
press: press 
horseman: horsemen 
diligently: diligently 
studio: studios studio 
coast: coast 
december: december 
excited: excited 
relief: relief 
photo: photo 
earth: earth 
vocal: vocals 
jimi: jimi 
shop: shop 
brewer: brewer 
filum: fila 
ny: ny 
barefoot: barefoot 
led: led 
mason: mason 
dead: dead 
designed: designed 
dollar: dollar 
tour: tour 
format: format 
section: section 
ml: ml 
shield: shield 
hearkened: hearkened 
watchtower: watchtower 
arena: arena 
none: none 
world: world 
jess: jess 
paul: paul 
angela: angela 
wine: wine 
band: band 
n: n 
nashville: nashville 
lyric: lyric lyrics 
chrissie: chrissie 
show: show 
berkowitz: berkowitz 
arise: arise 
th: th 
bob: bob 
j: j 
immigrant: immigrant 
mastered: mastered 
artist: artists 
meaning: meaning 
wetton: wetton 
covered: covered 
naim: naim 
cometh: cometh 
kenneth: kenneth 
harry: harry 
albert: albert 
embed: embed 
holding: holdings 
transcription: transcription 
job: jobs 
businessmen: businessmen 
eat: eat 
learn: learn 
grossman: grossman 
curry: curry 
couple: couple 
label: label 
dylan: dylan 
advertise: advertise 
lungo: lungo 
haven: havens 
men: men 
set: set 
f: f 
columbia: columbia 
lonesome: lonesome 
ye: ye 
anoint: anoint 
buttrey: buttrey 
upon: upon 
outside: outside 
e: e 
talk: talk 
michael: michael 
individual: individual 
mike: mike 
phonographic: phonographic 
ultimate: ultimate 
greatest: greatest 
rusted: rusted 
primera: primera 
bashers: bashers 
song: songs song 
rosa: rosa 
burgh: burgh 
lord: lord 
live: live 
licensing: licensing 
anniversary: anniversary 
music: music 
contact: contact 
along: along 
late: late 
drifter: drifter 
guitar: guitar 
nj: nj 
feel: feel 
theater: theater 
collection: collection 
grateful: grateful 
image: images 
keith: keith 
root: root 
approaching: approaching 
answered: answered 
kravitz: kravitz 
stand: stand 
isaiah: isaiah 
joke: joke 
hot: hot 
babylon: babylon 
said: said 
one: one 
de: de 
terre: terre 
bryan: bryan 
johnston: johnston 
saw: saw 
fan: fan 
heed: heed 
annotation: annotation 
million: million 
xtc: xtc 
video: videos 
p: p 
howl: howl 
add: add 
check: check 
flood: flood 
kindly: kindly 
sign: sign 
knob: knob 
richie: richie 
continually: continually 
rider: riders 
let: let 
harmonica: harmonica 
chariot: chariot 
le: les 
thus: thus 
armageddon: armageddon 
poor: poor 
war: war 
k: k 
hobo: hobo 
might: might 
design: design 
cupid: cupid 
worth: worth 
featured: featured 
spirit: spirit 
comment: comment comments 
much: much 
ask: ask 
joker: joker 
distance: distance 
ballad: ballad 
pressing: pressing 
among: among 
unto: unto 
manny: manny 
continental: continental 
drop: drop 
wind: wind 
seeth: seeth 
augustine: augustine 
cast: cast 
entertainment: entertainment 
haut: haut 
brian: brian 
rescue: rescue 
fate: fate 
h: h 
c: c 
clapton: clapton 
way: way 
guide: guide 
april: april 
camel: camels 
xli: xli 
began: began 
different: different 
publisher: publisher 
company: company 
promote: promote 
scholar: scholars 
lenny: lenny 
cat: cat 
forum: forum 
neil: neil 
hynde: hynde 
jam: jam 
daytime: daytime 
lucifer: lucifer 
distinguish: distinguish 
steve: steve 
vivo: vivo 
policy: policy 
verse: verse 
etc: etc 
dig: dig 
greenberg: greenberg 
coliseum: coliseum 
peach: peaches 
getting: getting 
halftime: halftime 
rock: rock 
eric: eric 
eddie: eddie 
ft: ft 
pine: pine 
use: use 
fact: facts 
merli: merli 
vocalist: vocalists 
ca: ca 
question: question 
like: like 
broken: broken 
god: gods 
written: written 
experience: experience 
trio: trio 
springsteen: springsteen 
singer: singer 
bruce: bruce 
genius: genius 
b: b 
recorded: recorded 
city: city 
alejandra: alejandra 
repeating: repeating 
florida: florida 
time: time 
manufacturer: manufacturer 
x: x 
cryptic: cryptic 
hath: hath 
weller: weller 
went: went 
plant: plant 
chart: charts 
spoke: spoke 
wildcat: wildcat 
growl: growl 
parallel: parallels 
brendan: brendan 
clarkston: clarkston 
psychedelic: psychedelic 
pearl: pearl 
cancel: cancel 
produced: produced 
llc: llc 
guzm: guzm 
cabrel: cabrel 
tito: tito 
declare: declare 
john: john 
vedetta: vedetta 
siamese: siamese 
really: really 
instrumental: instrumental 
calbi: calbi 
