camila: camila 
go: go 
interpolate: interpolate 
rhett: rhett 
disco: disco 
baby: baby 
following: following 
ground: ground 
created: created 
transcriber: transcribers 
march: march 
breathe: breathe 
aol: aol 
johnson: johnson 
marriage: marriage 
supposed: supposed 
princess: princess 
tree: tree 
sadies: sadies 
sean: sean 
receive: receive 
rocker: rocker 
dress: dress 
crossed: crossed 
match: match 
throwback: throwback 
note: notes 
put: put 
mashup: mashup 
engineer: engineer 
date: date 
traducciones: traducciones 
parrish: parrish 
mixing: mixing 
q: q 
v: v 
recording: recording 
afraid: afraid 
release: release 
portugu: portugu 
anything: anything 
preface: preface 
crazy: crazy 
autonomy: autonomy 
personal: personal 
twin: twin 
spanish: spanish 
richard: richard 
bop: bop 
joe: joe 
myles: myles 
scenario: scenario 
bersetzung: bersetzung 
type: type 
people: people 
sample: sample samples 
white: white 
share: share 
real: real 
whole: whole 
g: g 
line: lines 
belong: belong 
never: never 
sad: sad 
bit: bit 
love: love 
marked: marked 
two: two 
priv: priv 
publicist: publicists 
chad: chad 
misdelphia: misdelphia 
tell: tell 
cover: cover covers 
got: got 
expand: expand 
high: high 
relationship: relationship 
pick: pick 
alone: alone 
sweetheart: sweetheart 
link: link 
ring: ring 
e: es e 
stephen: stephen 
tag: tags 
daddy: daddy 
sebii: sebii 
z: z 
remixes: remixes 
extended: extended 
young: young 
modern: modern 
martin: martin 
always: always 
backcatalog: backcatalog 
brasil: brasil 
interview: interview 
bold: bold 
atv: atv 
balcony: balcony 
kidz: kidz 
view: view 
die: die 
except: except 
cause: cause 
sony: sony 
aesthetic: aesthetic 
channel: channel 
biggest: biggest 
chapter: chapter 
privacy: privacy 
breakdown: breakdown 
girl: girls 
italic: italics 
u: us u 
amas: amas 
happy: happy 
timeless: timeless 
alexis: alexis 
light: lights 
digital: digital 
wondering: wondering 
pop: pop 
save: save 
header: headers 
current: current 
information: information 
espa: espa 
guideline: guidelines 
else: else 
stay: stay 
man: man 
contributor: contributor contributors 
even: even 
yung: yung 
star: star 
coming: coming 
head: head 
part: parts part 
understand: understand 
read: read 
first: first 
reacted: reacted 
w: w 
cimorelli: cimorelli 
also: also 
ever: ever 
water: water 
day: day days 
scene: scene 
deutsch: deutsch 
songwriter: songwriter 
programmer: programmer 
em: em 
cry: crying 
dad: dad 
track: track 
know: know 
garden: garden 
performance: performances performance 
country: country 
staircase: staircase 
publishing: publishing 
radio: radio 
everything: everything 
luv: luv 
pair: pair 
cothran: cothran 
fifteen: fifteen 
credit: credits 
pebble: pebbles 
chorus: chorus 
musical: musical 
insight: insight 
inspired: inspired 
used: used 
scooter: scooter 
anthem: anthem 
additional: additional 
somewhere: somewhere 
mackin: mackin 
shalom: shalom 
billboard: billboard 
source: source sources 
summer: summer 
ryan: ryan 
brief: brief 
certification: certifications 
glaive: glaive 
lyn: lyn 
september: september 
term: terms 
felt: felt 
blame: blame 
although: although 
official: official 
copyright: copyright 
shiki: shiki 
outro: outro 
dispute: disputes 
knowledge: knowledge 
r: r 
fling: fling 
verified: verified 
liked: liked 
visit: visit 
dave: dave 
sell: sell 
escape: escape 
savannah: savannah 
year: year 
l: l 
search: search 
mash: mash 
black: black 
begging: begging 
new: new 
feeling: feeling 
school: school 
mastering: mastering 
developer: developers 
taylor: taylor 
mixed: mixed 
bersetzungen: bersetzungen 
think: think 
february: february 
perceived: perceived 
al: al 
ball: ball 
audio: audio 
press: press 
letter: letter 
chapman: chapman 
boy: boy boys 
flashback: flashback 
issue: issues 
studio: studios 
lover: lovers lover 
well: well 
kid: kids 
state: state 
shop: shop 
lovestory: lovestory 
ny: ny 
eye: eyes 
fail: fail 
going: going 
air: air 
subject: subject 
xo: xo 
dead: dead 
blackbird: blackbird 
easy: easy 
find: find 
format: format 
section: section 
scarlet: scarlet 
relate: relate 
last: last 
claimed: claimed 
ml: ml 
forever: forever 
sneak: sneak 
abdullah: abdullah 
los: los 
post: post 
carlson: carlson 
plot: plot 
ha: ha 
mess: mess 
world: world 
ol: ol 
band: band 
ftly: ftly 
n: n 
ending: ending 
lyric: lyric lyrics 
dating: dating 
j: j 
described: described 
der: der 
artist: artists artist 
portuguese: portuguese 
thought: thought 
claire: claire 
started: started 
dont: dont 
marry: marry 
dog: dog 
embed: embed 
romeo: romeo 
portray: portray 
holding: holdings 
transcription: transcription 
pen: pen 
job: jobs 
answer: answer 
learn: learn 
burrow: burrows 
tragedy: tragedy 
female: female 
horse: horse 
left: left 
far: far 
clear: clear 
label: label 
sarah: sarah 
turn: turn 
twitter: twitter 
record: records 
remover: remover 
version: version 
advertise: advertise 
oh: oh 
gone: gone 
boyfriend: boyfriend 
f: f 
chose: chose 
keep: keep 
collaborated: collaborated 
make: make 
hello: hello 
xaev: xaev 
talk: talk 
yandere: yandere 
sorry: sorry 
crowd: crowd 
hoodies: hoodies 
juliet: juliet 
assistant: assistant 
jeremy: jeremy 
individual: individual 
away: away 
ultimate: ultimate 
party: party 
officially: officially 
quiet: quiet 
deathdrop: deathdrop 
song: songs song 
take: take 
front: front 
sickest: sickest 
look: look 
mix: mix 
time: times time 
live: live 
licensing: licensing 
contractual: contractual 
could: could 
american: american 
eggnog: eggnog 
punk: punk 
music: music 
key: key 
contact: contact 
smith: smith 
big: big 
braun: braun 
actually: actually 
guitar: guitar 
nathan: nathan 
midi: midi 
standing: standing 
feel: feel 
epic: epic 
run: run 
collection: collection 
tradu: tradu 
remix: remix 
sought: sought 
fla: fla 
hot: hot 
united: united 
change: change 
right: rights 
said: said 
second: second 
one: one 
saw: saw 
video: video videos 
annotation: annotation 
utsc: utsc 
month: months 
thing: thing 
traducci: traducci 
p: p 
earworm: earworm 
rumored: rumored 
nu: nu 
anyone: anyone 
add: add 
check: check 
machine: machine 
margaret: margaret 
sign: sign 
come: come 
little: little 
became: became 
since: since 
peaked: peaked 
dariacore: dariacore 
manipulative: manipulative 
k: k 
might: might 
cupid: cupid 
halsey: halsey 
featured: featured 
knelt: knelt 
comment: comment comments 
style: style 
swift: swift 
say: say 
hey: hey 
proposal: proposal 
told: told 
career: career 
ask: ask 
pulled: pulled 
yes: yes 
edgeler: edgeler 
met: met 
angeles: angeles 
lapid: lapid 
van: van 
decade: decade 
around: around 
fading: fading 
drop: drop 
wrote: wrote 
entertainment: entertainment 
movie: movie 
bmi: bmi 
waiting: waiting 
business: business 
write: write 
rescue: rescue 
h: h 
faith: faith 
fearless: fearless 
theme: theme 
c: c 
better: better 
way: way 
guide: guide 
translation: translation translations 
dimension: dimension 
different: different 
began: began 
cassidi: cassidi 
prince: prince 
tired: tired 
good: good 
start: starts 
publisher: publisher 
loved: loved 
german: german 
cmt: cmt 
bridge: bridge 
original: original 
promote: promote 
frailty: frailty 
gustixa: gustixa 
scholar: scholars 
forum: forum 
annabeth: annabeth 
outskirt: outskirts 
difficult: difficult 
homeswitcher: homeswitcher 
distinguish: distinguish 
story: story stories 
salah: salah 
kiss: kiss 
policy: policy 
jonas: jonas 
pipeline: pipeline 
verse: verse 
etc: etc 
situation: situation 
hank: hank 
peach: peaches 
beginning: beginning 
tim: tim 
desire: desire 
explicitly: explicitly 
trying: trying 
ft: ft 
use: use 
cant: cant 
promise: promise 
fact: facts 
vocalist: vocalists 
dj: dj 
question: question 
best: best 
wheatley: wheatley 
like: like 
broken: broken 
written: written 
caption: caption 
singer: singers singer 
disapproval: disapproval 
kuil: kuil 
fnf: fnf 
sw: sw 
stripped: stripped 
genius: genius 
b: b 
fitting: fitting 
gamers: gamers 
recorded: recorded 
reinaeiry: reinaeiry 
knew: knew 
repeating: repeating 
x: x 
medley: medley 
octoling: octoling 
pre: pre 
williams: williams 
cabello: cabello 
image: image 
chart: charts 
week: weeks 
every: every 
gown: gowns 
please: please 
cancel: cancel 
produced: produced 
llc: llc 
differently: differently 
freedom: freedom 
london: london 
throwing: throwing 
girlfriend: girlfriend 
mingo: mingo 
stated: stated 
obsessed: obsessed 
deutsche: deutsche 
town: town 
talked: talked 
really: really 
pocket: pocket 
happen: happen 
award: awards 
close: close 
jane: jane 
see: see 
liner: liner 
