gratitude: gratitude 
stoop: stoop 
go: go 
leaving: leaving 
chappell: chappell 
canadiana: canadiana 
baby: baby 
titanic: titanic 
created: created 
transcriber: transcribers 
gnocato: gnocato 
dream: dream 
sisk: sisk 
tree: tree 
candle: candles 
featuring: featuring 
revealed: revealed 
picture: pictures 
ya: ya 
ross: ross 
start: start 
engineer: engineer 
date: date 
traducciones: traducciones 
mixing: mixing 
q: q 
lady: ladies 
collaboration: collaboration 
third: third 
v: v 
recording: recording 
huge: huge 
release: release 
later: later 
zubin: zubin 
personal: personal 
twin: twin 
spanish: spanish 
leave: leave 
would: would 
home: home 
liar: liar 
type: type 
taken: taken 
keyboard: keyboards 
socan: socan 
important: important 
share: share 
g: g 
line: lines 
vocal: vocal 
love: love 
haze: haze 
rewritten: rewritten 
tell: tell 
got: got 
expand: expand 
sing: sing 
tag: tags 
place: place 
z: z 
november: november 
known: known 
duet: duet 
young: young 
fake: fake 
always: always 
bold: bold 
atv: atv 
view: view 
sony: sony 
seara: seara 
biggest: biggest 
privacy: privacy 
trampoline: trampoline 
italic: italics 
u: us u 
girl: girls girl 
happy: happy 
light: lights light 
pop: pop 
table: table 
save: save 
header: headers 
information: information 
espa: espa 
guideline: guidelines 
man: man 
contributor: contributor contributors 
erban: erban 
even: even 
coming: coming 
part: parts part 
understand: understand 
read: read 
w: w 
collaborashawn: collaborashawn 
also: also 
christmas: christmas 
ever: ever 
day: day 
songwriter: songwriter 
programmer: programmer 
drum: drums 
track: track 
hand: hand 
country: country 
scar: scar 
publishing: publishing 
string: string 
remixed: remixed 
lose: lose 
credit: credits 
percussion: percussion 
chorus: chorus 
musical: musical 
insight: insight 
bass: bass 
source: source 
dying: dying 
long: long 
mysterious: mysterious 
term: terms 
ghenea: ghenea 
memory: memories 
official: official 
thank: thank 
copyright: copyright 
r: r 
knowledge: knowledge 
verified: verified 
visit: visit 
nice: nice 
sell: sell 
rule: rules 
dear: dear 
everybody: everybody 
kimber: kimber 
l: l 
taylorswift: taylorswift 
search: search 
new: new 
second: seconds 
platform: platforms 
developer: developers 
taylor: taylor 
think: think 
lonely: lonely 
al: al 
group: group 
press: press 
letter: letter 
seventh: seventh 
acoustic: acoustic 
shop: shop 
truth: truth 
eye: eyes 
finally: finally 
though: though 
format: format 
gentleman: gentlemen 
section: section 
ml: ml 
forever: forever 
harris: harris 
performance: performance 
honey: honey 
ah: ah 
world: world 
title: title 
ol: ol 
n: n 
lyric: lyric lyrics 
th: th 
j: j 
artist: artists 
single: single 
january: january 
eighty: eighty 
graveyard: graveyard 
til: til 
embed: embed 
holding: holdings 
transcription: transcription 
job: jobs 
answer: answer 
learn: learn 
mendes: mendes 
scott: scott 
album: album 
twitter: twitter 
dirtiest: dirtiest 
version: version 
advertise: advertise 
oh: oh 
call: call 
gone: gone 
hell: hell 
f: f 
sit: sit 
writer: writer 
make: make 
e: e 
assistant: assistant 
kitchen: kitchen 
individual: individual 
mike: mike 
phonographic: phonographic 
tamerlane: tamerlane 
ultimate: ultimate 
song: songs song 
george: george 
expressed: expressed 
take: take 
bunch: bunch 
look: look 
licensing: licensing 
could: could 
anyway: anyway 
music: music 
contact: contact 
laura: laura 
letting: letting 
medium: media 
guitar: guitar 
collection: collection 
remix: remix 
stand: stand 
force: force 
hot: hot 
seat: seat 
right: rights 
said: said 
fan: fan fans 
video: video videos 
annotation: annotation 
released: released 
took: took 
warner: warner 
traducci: traducci 
p: p 
dazzling: dazzling 
add: add 
check: check 
antonoff: antonoff 
sign: sign 
let: let 
lalala: lalala 
k: k 
might: might 
hour: hours 
cupid: cupid 
featured: featured 
comment: comment comments 
swift: swift 
ask: ask 
towards: towards 
ballad: ballad 
true: true 
joke: jokes 
darling: darling 
collaborate: collaborate 
around: around 
drop: drop 
wall: wall 
room: room 
entertainment: entertainment 
meet: meet 
bmi: bmi 
news: news 
write: write 
rescue: rescue 
hang: hang 
universal: universal 
h: h 
thakkar: thakkar 
c: c 
way: way 
canadian: canadian 
guide: guide 
translation: translation translations 
different: different 
producer: producer 
good: good 
publisher: publisher 
highest: highest 
bridge: bridge 
promote: promote 
scholar: scholars 
forum: forum 
social: social 
distinguish: distinguish 
rooney: rooney 
story: story 
policy: policy 
verse: verse 
fall: fall 
etc: etc 
peach: peaches 
someone: someone 
hanes: hanes 
ft: ft 
beautiful: beautiful 
use: use 
studio: studio 
fact: facts 
dance: dance 
vocalist: vocalists 
question: question 
like: like 
pilgrim: pilgrims 
jack: jack 
broken: broken 
corp: corp 
written: written 
singer: singer 
collide: collide 
genius: genius 
b: b 
recorded: recorded 
repeating: repeating 
year: years 
join: join 
friend: friends 
ascap: ascap 
time: time 
x: x 
magnetic: magnetic 
piano: piano 
cover: covers 
chart: charts 
shawn: shawn 
every: every 
please: please 
cancel: cancel 
produced: produced 
llc: llc 
john: john 
really: really 
called: called 
lover: lover 
close: close 
circle: circles 
see: see 
