holly: hollies 
interpolate: interpolate 
odetta: odetta 
following: following 
created: created 
transcriber: transcribers 
course: course 
fast: fast 
opening: opening 
somehow: somehow 
death: death 
folk: folk 
morning: mornings 
roam: roam 
ian: ian 
start: start 
saving: saving 
jennings: jennings 
critic: critics 
side: side 
jan: jan 
note: notes 
constant: constant 
date: date 
q: q 
god: god 
cher: cher 
v: v 
later: later 
release: release 
personal: personal 
twin: twin 
spanish: spanish 
maiden: maidens 
grown: grown 
namin: namin 
wheel: wheel 
type: type 
people: people 
tom: tom 
swimmin: swimmin 
speak: speak 
stalled: stalled 
water: waters 
share: share 
g: g 
line: lines line 
love: love 
sixty: sixties 
tell: tell 
aging: aging 
expand: expand 
slow: slow 
budokan: budokan 
get: get gets 
wall: walls 
del: del 
carroll: carroll 
tag: tags 
allied: allied 
z: z 
november: november 
mother: mothers 
blue: blues 
cambiando: cambiando 
young: young 
wilson: wilson 
prophesize: prophesize 
always: always 
bassy: bassy 
bold: bold 
view: view 
beach: beach 
sony: sony 
biggest: biggest 
tracy: tracy 
ferry: ferry 
privacy: privacy 
italic: italics 
u: us u 
farewell: farewell 
throughout: throughout 
cameron: cameron 
header: headers 
information: information 
guideline: guidelines 
else: else 
road: road 
contributor: contributor contributors 
beyond: beyond 
even: even 
many: many 
marc: marc 
part: parts part 
understand: understand 
read: read 
first: first 
w: w 
also: also 
songwriter: songwriter 
together: together 
pawn: pawn 
gimme: gimme 
guardianes: guardianes 
track: track 
hand: hand 
performance: performances 
country: country 
concise: concise 
credit: credits 
chorus: chorus 
brown: brown 
musical: musical 
insight: insight 
campaignin: campaignin 
chris: chris 
source: source 
congressman: congressmen 
long: long 
civil: civil 
term: terms 
copyright: copyright 
r: r 
knowledge: knowledge 
wherever: wherever 
verified: verified 
visit: visit 
sell: sell 
rattle: rattle 
hypnotic: hypnotic 
north: north 
l: l 
search: search 
loser: loser 
verse: verses verse 
new: new 
rapidly: rapidly 
sample: samples 
developer: developers 
come: comes come 
york: york 
pretty: pretty 
window: windows 
herbie: herbie 
purpose: purpose 
crowe: crowe 
group: group 
kennedy: kennedy 
remained: remained 
press: press 
almost: almost 
chapman: chapman 
jibjab: jibjab 
studio: studios 
acoustic: acoustic 
curse: curse 
shop: shop 
highway: highway 
ny: ny 
eye: eyes 
win: win 
mason: mason 
son: sons 
format: format 
section: section 
scottish: scottish 
ml: ml 
last: last 
gather: gather 
ragin: ragin 
sink: sink 
los: los 
seeker: seekers 
senator: senators 
campbell: campbell 
world: world 
n: n 
stone: stone 
lyric: lyric lyrics 
bob: bob 
irish: irish 
j: j 
chance: chance 
blackmore: blackmore 
artist: artists 
january: january 
game: game 
block: block 
play: play 
hattie: hattie 
embed: embed 
holding: holdings 
transcription: transcription 
pen: pen 
job: jobs 
answer: answer 
learn: learn 
album: album 
ray: ray 
dylan: dylan 
version: version 
advertise: advertise 
haven: havens 
call: call 
men: men 
f: f 
columbia: columbia 
ship: ship 
lonesome: lonesome 
ye: ye 
keep: keep 
boot: boots 
outside: outside 
e: e 
leather: leather 
present: present 
phil: phil 
individual: individual 
ultimate: ultimate 
hurt: hurt 
song: songs song 
molly: molly 
live: live 
time: times time 
wide: wide 
licensing: licensing 
boy: boys 
music: music 
contact: contact 
big: big 
round: round 
guitar: guitar 
father: fathers 
collection: collection 
shake: shake 
admit: admit 
stand: stand 
piled: piled 
hollis: hollis 
perez: perez 
hot: hot 
right: rights 
said: said 
hancock: hancock 
one: one 
bryan: bryan 
heed: heed 
old: old 
annotation: annotation 
video: videos 
mo: mo 
p: p 
add: add 
check: check 
sign: sign 
richie: richie 
drawn: drawn 
ballad: ballads ballad 
became: became 
harmonica: harmonica 
spin: spin 
k: k 
might: might 
cupid: cupid 
worth: worth 
tellin: tellin 
featured: featured 
comment: comment comments 
say: say 
bone: bone 
ask: ask 
kind: kind 
changin: changin 
changing: changing 
van: van 
around: around 
fading: fading 
drop: drop 
past: past 
cast: cast 
write: write 
rescue: rescue 
drenched: drenched 
h: h 
collins: collins 
command: command 
theme: theme 
c: c 
better: better 
battle: battle 
guide: guide 
hall: hall 
still: still 
way: way 
flogging: flogging 
short: short 
different: different 
producer: producer 
franky: franky 
promote: promote 
scholar: scholars 
forum: forum 
neil: neil 
accept: accept 
writer: writers 
distinguish: distinguish 
lend: lend 
policy: policy 
tender: tender 
daughter: daughters 
etc: etc 
doorway: doorway 
peach: peaches 
influenced: influenced 
gun: gun 
noise: noise 
ft: ft 
use: use 
fact: facts 
vocalist: vocalists 
protest: protest 
question: question 
like: like 
garfunkel: garfunkel 
broken: broken 
written: written 
keb: keb 
byrd: byrds 
bosque: bosque 
soon: soon 
gimmes: gimmes 
singer: singer 
president: president 
exactly: exactly 
genius: genius 
b: b 
recorded: recorded 
city: city 
hoge: hoge 
knew: knew 
repeating: repeating 
simon: simon 
x: x 
died: died 
whisper: whisper 
order: order 
tiempos: tiempos 
wanted: wanted 
criticize: criticize 
cover: covers 
chart: charts 
hearted: hearted 
restless: restless 
everyone: everyone 
night: night 
please: please 
cancel: cancel 
produced: produced 
llc: llc 
movement: movement 
land: land 
biograph: biograph 
definitely: definitely 
close: close 
word: words 
liner: liner 
