la: la 
go: go 
interpolate: interpolate 
british: british 
lucky: lucky 
player: player 
ground: ground 
created: created 
transcriber: transcribers 
sheeran: sheeran 
spent: spent 
port: port 
become: become 
death: death 
folk: folk 
featuring: featuring 
adjustment: adjustment 
done: done 
revealed: revealed 
musically: musically 
red: red 
butch: butch 
engineer: engineer 
date: date 
traducciones: traducciones 
mixing: mixing 
q: q 
collaboration: collaboration 
ali: ali 
v: v 
recording: recording 
huge: huge 
release: release 
crystal: crystals 
portugu: portugu 
want: want 
personal: personal 
tonight: tonight 
spanish: spanish 
twin: twin 
would: would 
home: home 
received: received 
iv: iv 
warren: warren 
elementary: elementary 
type: type 
people: people 
sample: sample samples 
asked: asked 
hit: hit 
feature: features 
level: level 
keyboard: keyboards 
arizona: arizona 
reached: reached 
tominaga: tominaga 
share: share 
making: making 
real: real 
mr: mr 
g: g 
line: lines 
sad: sad 
never: never 
love: love 
life: life 
two: two 
tell: tell 
trouble: trouble 
backyard: backyard 
got: got 
expand: expand 
penned: penned 
wall: walls 
m: ms 
e: es e 
tag: tags 
instead: instead 
place: place 
ago: ago 
z: z 
house: house 
open: open 
session: session 
joann: joann 
duet: duet 
cd: cd 
mind: mind 
mine: mine 
young: young 
appears: appears 
starlight: starlight 
came: came 
always: always 
thinking: thinking 
mtv: mtv 
shroud: shroud 
brasil: brasil 
bold: bold 
view: view 
flipped: flipped 
green: green 
working: working 
cause: cause 
biggest: biggest 
privacy: privacy 
ended: ended 
trampoline: trampoline 
italic: italics 
u: us u 
bouncing: bouncing 
happy: happy 
digital: digital 
freckle: freckles 
right: right 
pop: pop 
rafael: rafael 
header: headers 
portion: portions 
combined: combined 
information: information 
espa: espa 
guideline: guidelines 
emotionally: emotionally 
stay: stay 
contributor: contributor contributors 
work: work 
common: common 
even: even 
coming: coming 
part: parts part 
understand: understand 
read: read 
first: first 
w: w 
also: also 
forced: forced 
ever: ever 
collaborator: collaborator 
day: day days 
background: background 
magazine: magazine 
morning: morning 
songwriter: songwriter songwriters 
spy: spy 
wanna: wanna 
em: em 
drum: drums 
name: name 
seen: seen 
together: together 
smile: smile 
track: track 
know: know 
bollman: bollman 
landon: landon 
country: country 
everything: everything 
face: face 
worked: worked 
credit: credits 
stefanie: stefanie 
percussion: percussion 
chorus: chorus 
daughter: daughter 
musical: musical 
insight: insight 
tragic: tragic 
bass: bass 
inspired: inspired 
end: end 
tall: tall 
billboard: billboard 
source: source 
livestream: livestream 
friend: friend friends 
certification: certifications 
state: states state 
adult: adult 
term: terms 
camp: camps 
copyright: copyright 
outro: outro 
coordinator: coordinator 
july: july 
knowledge: knowledge 
r: r 
walker: walker 
verified: verified 
visit: visit 
sell: sell 
production: production productions 
austin: austin 
l: l 
search: search 
moment: moment 
lot: lot 
burnup: burnup 
meeting: meeting 
according: according 
brustofski: brustofski 
move: move 
new: new 
feeling: feeling feelings 
school: school 
mastering: mastering 
developer: developers 
reason: reason 
taylor: taylor 
hidden: hidden 
come: comes come 
maturity: maturity 
pretty: pretty 
think: think 
al: al 
french: french 
kennedy: kennedy 
trigwell: trigwell 
press: press 
almost: almost 
boy: boy 
lost: lost 
acoustic: acoustic 
well: well 
excited: excited 
string: strings 
vocal: vocals 
shop: shop 
eye: eyes 
missed: missed 
going: going 
entire: entire 
laughing: laughing 
friendly: friendly 
class: class 
format: format 
section: section 
taking: taking 
hard: hard 
tv: tv 
ml: ml 
last: last 
niebank: niebank 
back: back 
stomach: stomach 
treacherous: treacherous 
julia: julia 
world: world 
found: found 
ol: ol 
n: n 
lyric: lyric lyrics 
woke: woke 
hope: hopes 
th: th 
j: j 
one: ones one 
flight: flight 
artist: artists 
portuguese: portuguese 
meaning: meaning 
dynamic: dynamic 
ruby: ruby 
hannah: hannah 
follows: follows 
lightbody: lightbody 
looking: looking 
aj: aj 
embed: embed 
holding: holdings 
transcription: transcription 
job: jobs 
conor: conor 
answer: answer 
learn: learn 
sutherland: sutherland 
parr: parr 
scott: scott 
album: album 
holy: holy 
label: label 
simple: simple 
turn: turn 
record: records 
version: version 
advertise: advertise 
son: son 
oh: oh 
f: f 
chose: chose 
patrick: patrick 
upon: upon 
brought: brought 
writer: writer 
hello: hello 
jul: jul 
fun: fun 
message: message 
caitlin: caitlin 
dust: dust 
falling: falling 
assistant: assistant 
individual: individual 
kitchen: kitchen 
away: away 
ultimate: ultimate 
painted: painted 
song: songs song 
take: take 
performed: performed 
sun: sun 
look: look 
live: live 
licensing: licensing 
pouring: pouring 
butterfly: butterflies 
begin: begin 
changed: changed 
music: music 
contact: contact 
big: big 
actually: actually 
guitar: guitar 
change: changes change 
feel: feel 
tune: tune 
collection: collection 
tradu: tradu 
remix: remix 
lego: lego 
hot: hot 
keywest: keywest 
said: said 
second: second 
touring: touring 
sheer: sheer 
saw: saw 
fan: fan 
alike: alike 
regarding: regarding 
rain: rain 
video: video videos 
gotten: gotten 
annotation: annotation 
torus: tori 
traducci: traducci 
p: p 
add: add 
check: check 
english: english 
machine: machine 
sign: sign 
let: let 
since: since 
k: k 
demo: demo 
might: might 
hung: hung 
hour: hours 
harmonizing: harmonizing 
cupid: cupid 
composer: composer 
platonic: platonic 
featured: featured 
partnership: partnership 
comment: comment comments 
much: much 
held: held 
swift: swift 
sincere: sincere 
hey: hey 
spencer: spencer 
told: told 
ask: ask 
ballad: ballad 
kind: kind 
recalled: recalled 
met: met 
collaborate: collaborate 
grace: grace 
around: around 
drop: drop 
blown: blown 
wrote: wrote 
meet: meet 
blue: blue 
news: news 
write: write 
rescue: rescue 
showed: showed 
h: h 
calling: calling 
c: c 
realizing: realizing 
originally: originally 
better: better 
replied: replied 
guide: guide 
translation: translation translations 
battle: battle 
upside: upside 
sitting: sitting 
intro: intro 
different: different 
hotel: hotel 
stood: stood 
australia: australia 
justin: justin 
perspective: perspective 
good: good 
august: august 
highest: highest 
loved: loved 
bridge: bridge 
original: original 
promote: promote 
scholar: scholars 
deluxe: deluxe 
forum: forum 
hyannis: hyannis 
distinguish: distinguish 
another: another 
drew: drew 
misfit: misfits 
policy: policy 
verse: verse 
etc: etc 
hank: hank 
kelly: kelly 
peach: peaches 
someone: someone 
getting: getting 
argued: argued 
yesterday: yesterday 
several: several 
ft: ft 
beautiful: beautiful 
use: use 
sudden: sudden 
ed: ed 
studio: studio 
fact: facts 
vocalist: vocalists 
question: question 
like: like 
broken: broken 
hart: hart 
written: written 
something: something 
singer: singer 
bit: bits 
heard: heard 
genius: genius 
b: b 
recorded: recorded 
knew: knew 
repeating: repeating 
year: years 
time: time 
x: x 
medley: medley 
floor: floor 
writing: writing 
pre: pre 
door: door 
direction: direction 
wanted: wanted 
fourth: fourth 
williams: williams 
chord: chord 
cover: covers 
chart: charts 
girl: girl 
every: every 
sinclair: sinclair 
gary: gary 
night: night 
cancel: cancel 
produced: produced 
llc: llc 
jake: jake 
arranger: arranger 
really: really 
close: close 
child: children 
contemporary: contemporary 
see: see 
