apologetix: apologetix 
interpolate: interpolate 
moonshine: moonshine 
baby: baby 
interpolation: interpolations 
created: created 
transcriber: transcribers 
ronnie: ronnie 
johnny: johnny 
south: south 
death: death 
peace: peace 
oriented: oriented 
curtis: curtis 
buenos: buenos 
california: california 
javier: javier 
merry: merry 
gangsta: gangsta 
put: put 
king: king 
date: date 
q: q 
lady: ladies 
hope: hope 
mudhole: mudhole 
rossington: rossington 
v: v 
wheel: wheels 
huge: huge 
release: release 
fully: fully 
personal: personal 
twin: twin 
lt: lt 
home: home 
brook: brooks 
response: response 
phifer: phifer 
classic: classic 
type: type 
june: june 
people: people 
kooper: kooper 
sample: sample samples 
garth: garth 
clyde: clyde 
white: white 
shoal: shoals 
montgomery: montgomery 
share: share 
making: making 
mr: mr 
g: g 
line: lines line 
love: love 
two: two 
tell: tell 
various: various 
got: got 
expand: expand 
conservative: conservatives 
pick: pick 
misconstrue: misconstrue 
get: get 
sing: sing 
tag: tags 
z: z 
known: known 
bout: bout 
miss: miss 
mind: mind 
sport: sports 
young: young 
always: always 
rhythm: rhythm 
sweet: sweet 
bold: bold 
aire: aires 
killdozer: killdozer 
view: view 
question: questions question 
sky: skies 
burn: burns 
biggest: biggest 
privacy: privacy 
singing: singing 
protracted: protracted 
italic: italics 
u: us u 
pay: pay 
gym: gym 
kept: kept 
visiting: visiting 
header: headers 
sherlie: sherlie 
information: information 
guideline: guidelines 
man: man 
contributor: contributor contributors 
slavery: slavery 
even: even 
coming: coming 
part: parts part 
understand: understand 
read: read 
w: w 
breeze: breeze 
lordy: lordy 
also: also 
background: background 
oholibamah: oholibamah 
songwriter: songwriter 
drum: drums 
track: track 
garden: garden 
matthew: matthews 
country: country 
radio: radio 
credit: credits 
chorus: chorus 
musical: musical 
recanted: recanted 
insight: insight 
teacher: teacher 
bass: bass 
anthem: anthem 
canadian: canadians 
tall: tall 
clayton: clayton 
source: source 
summer: summer 
sin: sin 
long: long 
parody: parody 
believe: believe 
term: terms 
felt: felt 
zant: zant 
copyright: copyright 
r: r 
outro: outro 
knowledge: knowledge 
verified: verified 
kid: kid 
visit: visit 
biography: biography 
sell: sell 
typical: typical 
everlife: everlife 
l: l ls 
search: search 
black: black 
governor: governor 
feeling: feeling 
playing: playing 
kin: kin 
birmingham: birmingham 
heavy: heavy 
developer: developers 
license: license 
charly: charly 
think: think 
alabamy: alabamy 
al: al 
allen: allen 
group: group 
press: press 
powell: powell 
acoustic: acoustic 
well: well 
rehearsal: rehearsal 
accusatory: accusatory 
state: state 
boo: boo 
vocal: vocals 
bandit: bandits 
shop: shop 
gold: gold 
truth: truth 
geto: geto 
finally: finally 
easy: easy 
singin: singin 
georgia: georgia 
five: five 
format: format formats 
section: section 
frontman: frontman 
ml: ml 
back: back 
mont: mont 
calamaro: calamaro 
bottleneck: bottleneck 
ah: ah 
vant: vant 
seventy: seventies 
world: world 
ol: ol 
band: band 
yeah: yeah 
n: n 
lyric: lyric lyrics 
jawga: jawga 
racism: racism 
show: show 
bob: bob 
j: j 
described: described 
onto: onto 
artist: artists 
single: single 
thought: thought 
gangster: gangster 
waging: waging 
play: play 
often: often 
boyz: boyz 
embed: embed 
holding: holdings 
transcription: transcription 
job: jobs 
cox: cox 
answer: answer 
learn: learn 
mendes: mendes 
album: album 
label: label 
need: need 
listen: listen 
turn: turn 
record: records 
hair: hair 
version: version 
advertise: advertise 
oh: oh 
call: call 
recent: recent 
bother: bother 
f: f 
loew: loew 
keep: keep 
plate: plate 
carte: cartes 
e: e 
team: teams 
helping: helping 
individual: individual 
phonographic: phonographic 
ultimate: ultimate 
carry: carry 
leon: leon 
hippy: hippies 
song: songs song 
arrive: arrive 
lord: lord 
live: live 
saying: saying 
licensing: licensing 
could: could 
boy: boys 
music: music 
contact: contact 
laura: laura 
big: big 
guitar: guitar 
named: named 
alabama: alabama 
hallyday: hallyday 
collection: collection 
hot: hot 
remember: remember 
swamp: swamp 
said: said 
second: second 
one: one 
southland: southland 
cotton: cotton 
saw: saw 
cut: cut 
annotation: annotation 
video: videos 
p: p 
add: add 
check: check 
sign: sign 
come: come 
wilkeson: wilkeson 
let: let 
little: little 
doraville: doraville 
garc: garc 
bonn: bonn 
spoon: spoon 
mekhi: mekhi 
k: k 
might: might 
design: design 
cupid: cupid 
billy: billy 
featured: featured 
muscle: muscle 
comment: comment comments 
much: much 
mca: mca 
riff: riff 
eminem: eminem 
ask: ask 
ballad: ballad 
racist: racist 
yes: yes 
true: true 
van: van 
aor: aor 
around: around 
drop: drop 
wrote: wrote 
blue: blue 
waiting: waiting 
rescue: rescue 
watergate: watergate 
workin: workin 
thirty: thirty 
universal: universal 
h: h 
collins: collins 
gwar: gwar 
three: three 
c: c 
guide: guide 
way: way 
sitting: sitting 
intro: intro 
different: different 
bridge: bridge 
fan: fans 
promote: promote 
scholar: scholars 
forum: forum 
neil: neil 
turnin: turnin 
jam: jam 
solo: solo 
distinguish: distinguish 
dan: dan 
soundtrack: soundtrack 
anyhow: anyhow 
clydie: clydie 
conscience: conscience 
policy: policy 
verse: verse 
etc: etc 
postales: postales 
peach: peaches 
boogie: boogie 
shack: shacks 
rush: rush 
rock: rock 
gun: gun 
ft: ft 
lynyrd: lynyrd 
use: use 
ed: ed 
studio: studio 
fact: facts 
vocalist: vocalists 
like: like 
broken: broken 
written: written 
something: something 
singer: singer 
swampers: swampers 
lead: lead 
needle: needle 
staple: staple 
heard: heard 
owen: owen 
genius: genius 
b: b 
recorded: recorded 
repeating: repeating 
year: years 
florida: florida 
flowery: flowery 
guy: guys 
southern: southern 
time: time 
needed: needed 
full: full 
x: x 
piano: piano 
ssio: ssio 
see: see 
cover: covers 
skynyrd: skynyrd 
condescending: condescending 
chart: charts 
shawn: shawn 
mile: mile 
everyone: everyone 
gary: gary 
cancel: cancel 
produced: produced 
llc: llc 
jake: jake 
mansion: mansions 
land: land 
freestyle: freestyle 
called: called 
picking: picking 
word: words 
