square: square 
bone: bones 
ground: ground 
created: created 
transcriber: transcribers 
end: ends 
supposed: supposed 
somehow: somehow 
special: special 
drawer: drawer 
innocence: innocence 
lincoln: lincoln 
running: running 
red: red 
date: date 
bed: bed 
q: q 
v: v 
release: release releases 
buried: buried 
prayer: prayer 
want: want 
street: street 
personal: personal 
twin: twin 
would: would 
swear: swear 
cinema: cinema 
home: home 
tore: tore 
type: type 
announcement: announcement 
min: min 
crumpled: crumpled 
asked: asked 
reached: reached 
weight: weight 
share: share 
real: real 
g: g 
line: lines line 
never: never 
love: love 
glistened: glistened 
got: got 
expand: expand 
paint: paint 
night: nights night 
alone: alone 
get: get 
rare: rare 
hundred: hundred 
self: self 
tag: tags 
fly: fly 
place: place 
sacred: sacred 
z: z 
november: november 
house: house 
turning: turning 
bout: bout 
known: known 
mind: mind 
shirt: shirt 
cross: cross 
rose: rose 
always: always 
thinking: thinking 
sweet: sweet 
bold: bold 
watch: watch 
view: view 
affair: affair 
die: die 
cause: cause 
biggest: biggest 
forget: forget 
lovely: lovely 
privacy: privacy 
singing: singing 
italic: italics 
u: us u 
four: four 
pulse: pulse 
bathroom: bathroom 
alltoowelltenminuteversion: alltoowelltenminuteversion 
kept: kept 
pop: pop 
brooklyn: brooklyn 
header: headers 
information: information 
guideline: guidelines 
else: else 
stay: stay 
punch: punch 
asking: asking 
contributor: contributor contributors 
lnk: lnk 
even: even 
lookin: lookin 
part: parts part 
understand: understand 
read: read 
first: first 
w: w 
also: also 
ever: ever 
enough: enough 
store: store 
songwriter: songwriter 
oath: oath 
dancing: dancing 
name: name 
together: together 
dad: dad 
know: know 
country: country 
watched: watched 
credit: credits 
chorus: chorus 
musical: musical 
needy: needy 
walk: walk 
masterpiece: masterpiece 
insight: insight 
http: http 
used: used 
source: source 
long: long 
happened: happened 
whose: whose 
term: terms 
felt: felt 
skin: skin 
copyright: copyright 
r: r 
outro: outro 
available: available 
snow: snow 
knowledge: knowledge 
liz: liz 
gonna: gonna 
verified: verified 
thing: things thing 
kid: kid 
visit: visit 
idea: idea 
sell: sell 
tossing: tossing 
barren: barren 
l: l 
search: search 
taylorswift: taylorswift 
gaze: gaze 
shine: shine 
smell: smells 
mail: mail 
new: new 
picture: picture 
developer: developers 
tee: tee 
taylor: taylor 
york: york 
magic: magic 
ball: ball 
press: press 
bay: bay 
almost: almost 
lost: lost 
spoken: spoken 
acoustic: acoustic 
well: well 
willing: willing 
lover: lovers 
photo: photo 
weeping: weeping 
shop: shop 
air: air 
dead: dead 
find: find 
five: five 
mother: mother 
format: format 
section: section 
ml: ml 
alltoowelltheshortfilm: alltoowelltheshortfilm 
downloads: downloads 
charmed: charmed 
performance: performance 
back: back 
leaf: leaves 
light: light 
disposition: disposition 
go: goes 
older: older 
world: world 
yeah: yeah 
n: n 
maybe: maybe 
lyric: lyric lyrics 
celebrating: celebrating 
show: show 
cheek: cheeks 
fine: fine 
j: j 
artist: artists 
team: team 
single: single 
til: til 
grave: grave 
twenty: twenty 
embed: embed 
holding: holdings 
transcription: transcription 
job: jobs 
answer: answer 
learn: learn 
left: left 
album: album 
lying: lying 
listen: listen 
twitter: twitter 
version: version 
hair: hair 
advertise: advertise 
oh: oh 
actress: actress 
piece: pieces piece 
call: call 
gone: gone 
hell: hell 
f: f 
keep: keep 
e: e 
stair: stairs 
fun: fun 
flame: flame 
falling: falling 
kitchen: kitchen 
individual: individual 
reminds: reminds 
jewel: jewel 
ultimate: ultimate 
party: party 
bruise: bruise 
casually: casually 
age: age 
okay: okay 
song: songs song 
front: front 
live: live 
wide: wide 
licensing: licensing 
soldier: soldier 
could: could 
reflects: reflects 
music: music 
key: key keys 
contact: contact 
late: late 
amc: amc 
round: round 
double: double 
redtaylorsversion: redtaylorsversion 
guitar: guitar 
wondered: wondered 
paper: paper 
rid: rid 
premiere: premiere 
theater: theater 
returning: returning 
collection: collection 
lifeless: lifeless 
honest: honest 
walked: walked 
nobody: nobody 
frame: frame 
maim: maim 
hot: hot 
remember: remember 
said: said 
one: one 
fell: fell 
old: old 
effacing: effacing 
paralyzed: paralyzed 
annotation: annotation 
month: months 
video: videos 
p: p 
sister: sister 
made: made 
future: future 
add: add 
check: check 
sign: sign 
come: come 
car: car 
favorite: favorite 
little: little 
telling: telling 
via: via 
k: k 
might: might 
hour: hours 
cupid: cupid 
featured: featured 
comment: comment comments 
much: much 
sized: sized 
held: held 
swift: swift 
say: say 
told: told 
ask: ask 
eyed: eyed 
ballad: ballad 
skipping: skipping 
com: com 
joke: jokes 
shame: shame 
autumn: autumn 
drop: drop 
counter: counter 
wind: wind 
past: past 
alternative: alternative 
scared: scared 
blue: blue 
glass: glasses 
middle: middle 
rescue: rescue 
h: h 
plaza: plaza 
closer: closer 
three: three 
c: c 
originally: originally 
translation: translation 
guide: guide 
still: still 
announced: announced 
fuck: fuck 
different: different 
good: good 
loved: loved 
patriarchy: patriarchy 
vault: vault 
bridge: bridge 
fan: fans 
promote: promote 
scholar: scholars 
secret: secret 
scarf: scarf 
forum: forum 
distinguish: distinguish 
policy: policy 
verse: verse 
fall: fall 
etc: etc 
peach: peaches 
getting: getting 
rock: rock 
trying: trying 
drive: drive 
half: half 
use: use 
promise: promise 
fact: facts 
vocalist: vocalists 
week: week 
refrigerator: refrigerator 
question: question 
like: like 
day: days 
broken: broken 
experience: experience 
written: written 
something: something 
singer: singer 
genius: genius 
b: b 
recorded: recorded 
city: city 
coffee: coffee 
repeating: repeating 
guy: guys 
time: time 
x: x 
needed: needed 
broke: broke 
cold: cold 
sipping: sipping 
pre: pre 
went: went 
swearing: swearing 
chain: chain 
door: door 
break: break 
upstate: upstate 
minute: minute 
chart: charts 
followed: followed 
every: every 
cancel: cancel 
produced: produced 
llc: llc 
story: stories 
ran: ran 
plaid: plaid 
cruel: cruel 
town: town 
called: called 
rerelease: rerelease 
nothing: nothing 
