go: go 
interpolate: interpolate 
created: created 
transcriber: transcribers 
tune: tunes 
sean: sean 
fauntleroy: fauntleroy 
folk: folk 
featuring: featuring 
bluegrass: bluegrass 
montana: montana 
sometimes: sometimes 
start: start 
timbaland: timbaland 
red: red 
engineer: engineer 
date: date 
melody: melody 
mixing: mixing 
q: q 
collaboration: collaboration 
third: third 
v: v 
recording: recording 
release: release 
want: want 
personal: personal 
tonight: tonight 
twin: twin 
bop: bop 
elliott: elliott 
type: type 
ben: ben 
james: james 
sample: sample samples 
feature: features 
filthy: filthy 
supply: supplies 
share: share 
g: g 
line: lines 
vocal: vocal 
bit: bit 
love: love 
two: two 
tell: tell 
expand: expand 
annual: annual 
refrain: refrain 
cape: cape 
get: get 
tag: tags 
americana: americana 
jungle: jungle 
z: z 
remixes: remixes 
young: young 
came: came 
always: always 
mhmm: mhmm 
rhythm: rhythm 
bold: bold 
kidz: kidz 
view: view 
rising: rising 
dreamer: dreamers 
vitamin: vitamin 
biggest: biggest 
strongly: strongly 
privacy: privacy 
italic: italics 
u: us u 
ken: ken 
plan: plan 
scalladosis: scalladosis 
mullins: mullins 
midnight: midnight 
right: right rights 
pop: pop 
header: headers 
information: information 
guideline: guidelines 
man: man 
contributor: contributor contributors 
work: work 
even: even 
part: parts part 
understand: understand 
lujan: lujan 
read: read 
first: first 
w: w 
breeze: breeze 
also: also 
morning: morning 
songwriter: songwriter 
wanna: wanna 
name: name 
together: together 
danjahandz: danjahandz 
track: track 
country: country 
publishing: publishing 
electronic: electronic 
help: help 
string: string 
kutch: kutch 
credit: credits 
process: process 
chorus: chorus 
musical: musical 
volumeeventureslic: volumeeventureslic 
insight: insight 
chris: chris 
additional: additional 
somewhere: somewhere 
billboard: billboard 
timberlake: timberlake 
source: source 
summer: summer 
worsnop: worsnop 
term: terms 
santiago: santiago 
official: official 
copyright: copyright 
r: r 
knowledge: knowledge 
verified: verified 
thing: things 
visit: visit 
dave: dave 
sesac: sesac 
great: great 
sell: sell 
production: production 
everybody: everybody 
l: l 
search: search 
lot: lot 
heart: heart 
mastering: mastering 
livin: livin 
developer: developers 
quartet: quartet 
mixed: mixed 
root: roots 
danny: danny 
group: group 
electro: electro 
danja: danja 
press: press 
studio: studios studio 
acoustic: acoustic 
single: singles single 
kid: kids 
necessarily: necessarily 
shop: shop 
going: going 
nothin: nothin 
grammy: grammy 
cma: cma 
cocktail: cocktail 
flannel: flannel 
previous: previous 
tennman: tennman 
format: format 
rance: rance 
section: section 
caught: caught 
hard: hard 
ml: ml 
performance: performance 
light: light 
los: los 
post: post 
vb: vb 
acclaimed: acclaimed 
world: world 
yeah: yeah 
n: n 
maybe: maybe 
lyric: lyric lyrics 
reservoir: reservoir 
rca: rca 
th: th 
j: j 
chance: chance 
artist: artists 
january: january 
sound: sounds 
stapleton: stapleton 
pond: pond 
looking: looking 
bbx: bbx 
say: says say 
embed: embed 
holding: holdings 
transcription: transcription 
job: jobs 
nominee: nominees 
hip: hips 
answer: answer 
learn: learn 
album: album 
record: records 
version: version 
advertise: advertise 
know: knows 
hear: hear 
call: call 
f: f 
higher: higher 
alright: alright 
e: e 
blast: blast 
assistant: assistant 
individual: individual 
phonographic: phonographic 
ultimate: ultimate 
greatest: greatest 
song: songs song 
take: take 
performed: performed 
live: live 
licensing: licensing 
music: music 
contact: contact 
duo: duo 
medium: media 
guitar: guitar 
muzik: muzik 
collection: collection 
remix: remix 
hop: hop 
force: force 
hot: hot 
fluid: fluid 
one: one 
video: video videos 
annotation: annotation 
released: released 
warner: warner 
p: p 
add: add 
check: check 
sign: sign 
via: via 
interlude: interlude 
k: k 
might: might 
cupid: cupid 
featured: featured 
molotov: molotov 
comment: comment comments 
ask: ask 
angeles: angeles 
bengineer: bengineer 
nonstop: nonstop 
drop: drop 
blue: blue 
minimal: minimal 
bmi: bmi 
sauce: sauce 
write: write 
middle: middle 
rescue: rescue 
universal: universal 
h: h 
ooh: ooh 
stuff: stuff 
c: c 
way: way 
guide: guide 
still: still 
wood: woods 
justin: justin 
intro: intro 
different: different 
producer: producer 
wave: wave 
publisher: publisher 
promote: promote 
creative: creative 
matty: matty 
scholar: scholars 
forum: forum 
jam: jam 
distinguish: distinguish 
policy: policy 
verse: verse 
etc: etc 
sammy: sammy 
peach: peaches 
tucky: tucky 
influenced: influenced 
whoa: whoa 
contrast: contrast 
ft: ft 
nike: nike 
use: use 
fact: facts 
vocalist: vocalists 
ca: ca 
question: question 
best: best 
like: like 
broken: broken 
godbey: godbey 
written: written 
conway: conway 
something: something 
singer: singer 
genius: genius 
b: b 
recorded: recorded 
city: city 
repeating: repeating 
ascap: ascap 
guy: guys 
sedano: sedano 
x: x 
writing: writing 
experimental: experimental 
isosine: isosine 
piano: piano 
harmony: harmony 
pre: pre 
went: went 
klein: klein 
direction: direction 
fourth: fourth 
cover: covers 
chart: charts 
everyone: everyone 
ives: ives 
cancel: cancel 
produced: produced 
llc: llc 
land: land 
arranger: arranger 
really: really 
award: awards 
transgression: transgressions 
instrumental: instrumental 
contemporary: contemporary 
nothing: nothing 
