go: go 
mark: mark 
lucky: lucky 
speaking: speaking 
interpolation: interpolations 
ground: ground 
created: created 
transcriber: transcribers 
breathe: breathe 
sisk: sisk 
forcing: forcing 
sean: sean 
death: death 
folk: folk 
rumoured: rumoured 
wasted: wasted 
bryce: bryce 
red: red 
constant: constant 
engineer: engineer 
date: date 
traducciones: traducciones 
mixing: mixing 
q: q 
v: v 
recording: recording 
release: release 
portugu: portugu 
anything: anything 
personal: personal 
twin: twin 
spanish: spanish 
leave: leave 
home: home 
evan: evan 
type: type 
apartment: apartment 
keyboard: keyboards 
orchestral: orchestral 
share: share 
traductions: traductions 
g: g 
line: lines 
sad: sad 
never: never 
vocal: vocal vocals 
love: love 
life: life 
thread: thread 
trouble: trouble 
flight: flights 
synthesizer: synthesizer 
expand: expand 
high: high 
relationship: relationship 
listening: listening 
night: nights night 
health: health 
e: es e 
tag: tags 
instead: instead 
z: z 
november: november 
lauren: lauren 
young: young 
starlight: starlight 
always: always 
brasil: brasil 
bold: bold 
watch: watch 
view: view 
green: green 
gravity: gravity 
mental: mental 
unreviewed: unreviewed 
aise: aise 
biggest: biggest 
pedal: pedal 
privacy: privacy 
screaming: screaming 
italic: italics 
u: us u 
ai: ais aises 
happy: happy 
bio: bio 
voice: voice 
babe: babe 
breaking: breaking 
light: lights 
pop: pop 
header: headers 
trumpet: trumpet 
information: information 
puzzle: puzzles 
espa: espa 
guideline: guidelines 
stay: stay 
contributor: contributor contributors 
man: man 
erban: erban 
addiction: addiction 
even: even 
head: head 
part: parts part 
understand: understand 
w: w 
first: first 
also: also 
bottle: bottle 
ever: ever 
day: day days 
background: background 
smile: smiles 
songwriter: songwriter 
programmer: programmer 
drum: drums 
em: em 
together: together 
track: track 
know: know 
steel: steel 
country: country 
everything: everything 
checking: checking 
string: string 
credit: credits 
percussion: percussion 
chorus: chorus 
musical: musical 
insight: insight 
tragic: tragic 
perform: perform 
bass: bass 
reyes: reyes 
used: used 
billboard: billboard 
source: source 
summer: summer 
friend: friend 
long: long 
prevodi: prevodi 
adult: adult 
believe: believe 
term: terms 
ghenea: ghenea 
farsi: farsi 
copyright: copyright 
r: r 
outro: outro 
knowledge: knowledge 
verified: verified 
visit: visit 
sell: sell 
l: l 
search: search 
moment: moment 
begging: begging 
david: david 
new: new 
school: school 
mastering: mastering 
sample: samples 
developer: developers 
taylor: taylor 
sher: sher 
come: comes come 
slide: slide 
think: think 
al: al 
solve: solve 
press: press 
issue: issues 
almost: almost 
acoustic: acoustic 
well: well 
srpski: srpski 
state: state 
shop: shop 
saxophone: saxophone 
marquez: marquez 
format: format 
section: section 
hard: hard 
ml: ml 
last: last 
forever: forever 
back: back 
get: gets 
treacherous: treacherous 
post: post 
decide: decide 
world: world 
ol: ol 
worry: worry 
n: n 
ending: ending 
lyric: lyric lyrics 
fine: fine 
j: j 
debuted: debuted 
artist: artists 
portuguese: portuguese 
laugh: laugh 
bordone: bordone 
fran: fran 
mind: minds 
say: says say 
embed: embed 
holding: holdings 
transcription: transcription 
job: jobs 
answer: answer 
learn: learn 
riddleberger: riddleberger 
holy: holy 
ex: ex 
label: label 
action: actions 
version: version 
record: records 
advertise: advertise 
piece: pieces 
rowe: rowe 
sings: sings 
winter: winter 
call: call 
gone: gone 
f: f 
traduction: traduction 
personnel: personnel 
message: message 
michael: michael 
assistant: assistant 
individual: individual 
merrill: merrill 
away: away 
phonographic: phonographic 
republic: republic 
ultimate: ultimate 
jeff: jeff 
jon: jon 
song: songs song 
take: take 
sun: sun 
live: live 
licensing: licensing 
begin: begin 
changed: changed 
music: music 
contact: contact 
laura: laura 
smith: smith 
guitar: guitar 
darkest: darkest 
named: named 
lang: lang 
standing: standing 
run: run 
collection: collection 
tradu: tradu 
disarm: disarm 
hot: hot 
one: one 
pacing: pacing 
old: old 
annotation: annotation 
thing: thing 
video: videos 
traducci: traducci 
disrupted: disrupted 
p: p 
flute: flute 
add: add 
check: check 
antonoff: antonoff 
sign: sign 
passionate: passionate 
ronan: ronan 
struggling: struggling 
k: k 
demo: demo 
phase: phase 
might: might 
christopher: christopher 
cupid: cupid 
featured: featured 
comment: comment comments 
much: much 
swift: swift 
ask: ask 
pulled: pulled 
ballad: ballad 
miscommunication: miscommunication 
grace: grace 
around: around 
drop: drop 
past: past 
alternative: alternative 
scared: scared 
rescue: rescue 
kamen: kamen 
h: h 
noting: noting 
c: c 
better: better 
guide: guide 
translation: translation translations 
wishing: wishing 
bomb: bomb 
electric: electric 
different: different 
vault: vault 
bridge: bridge 
promote: promote 
scholar: scholars 
forum: forum 
distinguish: distinguish 
rooney: rooney 
policy: policy 
verse: verse 
fall: fall 
etc: etc 
peach: peaches 
getting: getting 
rock: rock 
commercially: commercially 
randy: randy 
trying: trying 
beautiful: beautiful 
use: use 
symphony: symphony 
studio: studio 
fact: facts 
vocalist: vocalists 
foster: foster 
week: week 
question: question 
like: like 
jack: jack 
broken: broken 
hart: hart 
written: written 
spends: spends 
singer: singer 
mellotron: mellotron 
genius: genius 
b: b 
chart: chart charts 
stress: stress 
hears: hears 
knew: knew 
repeating: repeating 
dubbed: dubbed 
prevod: prevod 
seems: seems 
time: time 
x: x 
floor: floor 
pre: pre 
bet: bet 
hutchinson: hutchinson 
minute: minute 
endure: endure 
girl: girl 
every: every 
please: please 
cancel: cancel 
produced: produced 
llc: llc 
pull: pull 
john: john 
cole: cole 
contemporary: contemporary 
nothing: nothing 
