guideline: guidelines 
lindsey: lindsey 
k: k 
might: might 
chappell: chappell 
contributor: contributor contributors 
tried: tried 
cupid: cupid 
featured: featured 
even: even 
comment: comment comments 
much: much 
created: created 
world: world 
transcriber: transcribers 
part: parts part 
understand: understand 
w: w 
yeah: yeah 
n: n 
grand: grand 
ask: ask 
also: also 
nashville: nashville 
bottle: bottle 
maybe: maybe 
lyric: lyric lyrics 
mckenna: mckenna 
j: j 
spotify: spotify 
wanna: wanna 
peace: peace 
artist: artists 
laugh: laugh 
drop: drop 
smile: smile 
track: track 
harry: harry 
country: country 
endurance: endurance 
publishing: publishing 
ghost: ghosts 
embed: embed 
holding: holdings 
everything: everything 
bmi: bmi 
transcription: transcription 
job: jobs 
grone: grone 
opry: opry 
bbc: bbc 
rescue: rescue 
crush: crush 
learn: learn 
date: date 
credit: credits 
hate: hate 
bed: bed 
universal: universal 
h: h 
chorus: chorus 
q: q 
musical: musical 
c: c 
v: v 
insight: insight 
way: way 
guide: guide 
ole: ole 
u: u us 
release: release 
hair: hair 
want: want 
crazy: crazy 
advertise: advertise 
personal: personal 
oh: oh 
know: knows 
twin: twin 
different: different 
version: version 
source: source 
publisher: publisher 
f: f 
long: long 
promote: promote 
scholar: scholars 
forum: forum 
type: type 
style: styles 
september: september 
slowing: slowing 
term: terms 
uk: uk 
distinguish: distinguish 
copyright: copyright 
sleep: sleep 
r: r 
e: e 
knowledge: knowledge 
liz: liz 
blonde: blonde 
bad: bad 
verified: verified 
policy: policy 
share: share 
verse: verse 
real: real 
etc: etc 
visit: visit 
concord: concord 
individual: individual 
taste: taste 
sell: sell 
g: g 
beginning: beginning 
line: lines 
drown: drown 
peach: peaches 
tamerlane: tamerlane 
rush: rush 
love: love 
two: two 
ultimate: ultimate 
l: l 
search: search 
tell: tell 
whisperin: whisperin 
use: use 
cover: cover 
got: got 
expand: expand 
fact: facts 
song: songs song 
heart: heart 
vocalist: vocalists 
blomerati: blomerati 
performed: performed 
lord: lord 
question: question 
get: get 
like: like 
licensing: licensing 
broken: broken 
touch: touch 
corp: corp 
developer: developers 
written: written 
music: music 
tag: tags 
contact: contact 
big: big 
z: z 
november: november 
hillary: hillary 
genius: genius 
b: b 
tennessee: tennessee 
lori: lori 
recorded: recorded 
mind: mind 
magic: magic 
group: group 
repeating: repeating 
rose: rose 
ascap: ascap 
collection: collection 
press: press 
x: x 
thinking: thinking 
always: always 
bold: bold 
metropolis: metropolis 
studio: studios 
acoustic: acoustic 
admit: admit 
single: singles 
view: view 
perfume: perfume 
hot: hot 
cause: cause 
right: rights 
bryan: bryan 
alpha: alpha 
shop: shop 
biggest: biggest 
gold: gold 
chart: charts 
bmg: bmg 
girl: girl 
privacy: privacy 
lip: lips 
annotation: annotation 
italic: italics 
sheet: sheets 
cancel: cancel 
produced: produced 
warner: warner 
llc: llc 
video: videos 
p: p 
london: london 
pullin: pullin 
add: add 
givin: givin 
check: check 
sign: sign 
town: town 
midnight: midnight 
format: format 
section: section 
pop: pop 
perfomance: perfomance 
little: little 
ml: ml 
header: headers 
information: information 
