guideline: guidelines 
k: k 
moanin: moanin 
griffin: griffin 
stay: stay 
frank: frank 
might: might 
leaving: leaving 
contributor: contributor contributors 
tried: tried 
matter: matter 
cupid: cupid 
baby: baby 
featured: featured 
even: even 
comment: comment comments 
gal: gal 
created: created 
world: world 
transcriber: transcribers 
say: say 
ol: ol 
part: parts part 
understand: understand 
ronnie: ronnie 
read: read 
first: first 
n: n 
emmett: emmett 
ask: ask 
dream: dream 
also: also 
positive: positive 
lyric: lyric lyrics 
wynette: wynette 
show: show 
day: day 
somehow: somehow 
patsy: patsy 
kind: kind 
j: j 
songwriter: songwriter 
reaction: reaction 
artist: artists 
thought: thought 
hayride: hayride 
around: around 
drop: drop 
lafarge: lafarge 
rime: rimes 
track: track 
popular: popular 
know: know 
orchestra: orchestra 
country: country 
foreign: foreign 
embed: embed 
holding: holdings 
transcription: transcription 
job: jobs 
viral: viral 
sat: sat 
milsap: milsap 
rescue: rescue 
answer: answer 
reaching: reaching 
learn: learn 
norrie: norrie 
date: date 
credit: credits 
hate: hate 
jr: jr 
locklin: locklin 
h: h 
chorus: chorus 
loving: loving 
q: q 
musical: musical 
rex: rex 
c: c 
v: v 
insight: insight 
guide: guide 
recording: recording 
u: u us 
release: release 
louisiana: louisiana 
used: used 
version: version 
ramblin: ramblin 
fact: facts 
advertise: advertise 
personal: personal 
oh: oh 
twin: twin 
different: different 
hear: hear 
billboard: billboard 
number: number 
tammy: tammy 
gone: gone 
herzog: herzog 
would: would 
grown: grown 
ryan: ryan 
f: f 
friend: friend 
source: source 
long: long 
meme: memes 
promote: promote 
elliott: elliott 
leann: leann 
scholar: scholars 
forum: forum 
lonesome: lonesome 
ronstadt: ronstadt 
type: type 
keep: keep 
term: terms 
cline: cline 
sample: sample samples 
distinguish: distinguish 
make: make 
copyright: copyright 
sigh: sigh 
mgm: mgm 
e: e 
lawd: lawd 
knowledge: knowledge 
r: r 
tonk: tonk 
verified: verified 
sugar: sugar 
policy: policy 
share: share 
verse: verse 
etc: etc 
visit: visit 
hank: hank 
individual: individual 
sell: sell 
peyroux: peyroux 
g: g 
line: lines 
peach: peaches 
love: love 
decided: decided 
ultimate: ultimate 
l: l 
search: search 
fred: fred 
pokey: pokey 
tell: tell 
audience: audience 
ft: ft 
beautiful: beautiful 
satisfied: satisfied 
lynn: lynn 
use: use 
got: got 
expand: expand 
studio: studio 
song: songs song 
heart: heart 
lovesick: lovesick 
vocalist: vocalists 
george: george 
ramsey: ramsey 
walmart: walmart 
cincinnati: cincinnati 
performed: performed 
lord: lord 
feeling: feeling 
performance: performance 
question: question 
cullum: cullum 
like: like 
licensing: licensing 
jack: jack 
broken: broken 
could: could 
developer: developers 
call: calls 
spot: spot 
written: written 
music: music 
key: key 
tag: tags 
daddy: daddy 
contact: contact 
singer: singer 
ifield: ifield 
z: z 
think: think 
paramor: paramor 
jamie: jamie 
remixes: remixes 
genius: genius 
b: b 
blue: blues 
recorded: recorded 
mill: mills 
repeating: repeating 
madeleine: madeleine 
adam: adams 
receiving: receiving 
rose: rose 
seems: seems 
stewart: stewart 
collection: collection 
press: press 
x: x 
always: always 
remix: remix 
linda: linda 
sweet: sweet 
bold: bold 
lost: lost 
nobody: nobody 
well: well 
view: view 
care: care 
single: singles 
went: went 
hot: hot 
williams: williams 
inspiring: inspiring 
said: said 
one: one 
shop: shop 
cliff: cliff 
cover: covers 
biggest: biggest 
dolly: dolly 
w: w 
chart: charts 
loretta: loretta 
video: video videos 
privacy: privacy 
irving: irving 
singing: singing 
annotation: annotation 
major: major 
italic: italics 
released: released 
retro: retro 
gary: gary 
air: air 
mason: mason 
cancel: cancel 
produced: produced 
jonxgb: jonxgb 
llc: llc 
p: p 
add: add 
check: check 
sign: sign 
come: come 
format: format 
section: section 
strait: strait 
called: called 
ml: ml 
last: last 
honky: honky 
header: headers 
since: since 
cry: cry 
miller: miller 
information: information 
parton: parton 
goodbye: goodbye 
