wallen: wallen 
go: go 
shane: shane 
baby: baby 
created: created 
ted: ted 
transcriber: transcribers 
dream: dream 
dirt: dirt 
south: south 
wasted: wasted 
put: put 
red: red 
engineer: engineer 
date: date 
traducciones: traducciones 
q: q 
drinkin: drinkin 
cooke: cooke 
v: v 
bartender: bartender 
quittin: quittin 
recording: recording 
huge: huge 
release: release 
letter: letters 
personal: personal 
twin: twin 
spanish: spanish 
received: received 
response: response 
type: type 
people: people 
keyboard: keyboards 
east: east 
white: white 
share: share 
making: making 
g: g 
line: lines 
sad: sad 
never: never 
love: love 
life: life 
wait: wait 
josh: josh 
bought: bought 
cover: cover covers 
rvshvd: rvshvd 
got: got 
expand: expand 
relationship: relationship 
get: get 
balding: balding 
film: film 
tag: tags 
daddy: daddy 
ago: ago 
z: z 
somebody: somebody 
house: house 
bout: bout 
loud: loud 
jerry: jerry 
always: always 
thinking: thinking 
sweet: sweet 
bold: bold 
fence: fence 
view: view 
unreviewed: unreviewed 
cause: cause 
biggest: biggest 
roe: roe 
conjunction: conjunction 
privacy: privacy 
mandolin: mandolin 
italic: italics 
u: us u 
happy: happy 
diamond: diamond 
bio: bio 
whiskey: whiskey 
right: right 
pop: pop 
boost: boost 
header: headers 
information: information 
espa: espa 
guideline: guidelines 
sippin: sippin 
proud: proud 
contributor: contributor 
even: even 
part: parts part 
understand: understand 
w: w 
first: first 
cohen: cohen 
also: also 
sixer: sixer 
editor: editor 
ever: ever 
enough: enough 
background: background 
lee: lee 
comfort: comfort 
songwriter: songwriter 
warning: warning 
drum: drums 
road: roads 
whatcha: whatcha 
morgan: morgan 
track: track 
know: know knows 
hand: hand 
bar: bar 
country: country 
round: rounds round 
turned: turned 
shit: shit 
gecewicz: gecewicz 
england: england 
lasted: lasted 
goin: goin 
redneck: rednecks 
credit: credits 
chorus: chorus 
musical: musical 
debut: debut 
insight: insight 
early: early 
bass: bass 
used: used 
somewhere: somewhere 
app: app 
billboard: billboard 
source: source 
summer: summer summers 
ryan: ryan 
certification: certifications 
long: long 
term: terms 
blame: blame 
coke: coke 
jensen: jensen 
official: official 
r: r 
copyright: copyright 
knowledge: knowledge 
verified: verified 
thing: things thing 
visit: visit 
dave: dave 
sell: sell 
instagram: instagram 
year: year years 
hometown: hometown 
l: l 
search: search 
beer: beer 
gave: gave 
lot: lot 
mastering: mastering 
wonder: wonder wonders 
tik: tik 
silverado: silverado 
livin: livin 
developer: developers 
acre: acres 
sutton: sutton 
cool: cool 
think: think thinks 
dumb: dumb 
tennessee: tennessee 
al: al 
group: group 
press: press 
boy: boy 
seven: seven 
acoustic: acoustic 
vocal: vocals 
seth: seth 
shop: shop 
highway: highway 
eye: eyes 
going: going 
reminisces: reminisces 
find: find 
format: format 
section: section 
ml: ml 
forever: forever 
performance: performance 
back: back 
post: post 
world: world 
mcanally: mcanally 
ol: ol 
yeah: yeah 
n: n 
maybe: maybe 
lyric: lyric lyrics 
sloas: sloas 
played: played 
j: j 
artist: artists artist 
seeing: seeing 
meaning: meaning 
started: started 
glad: glad 
problem: problem 
embed: embed 
holding: holdings 
transcription: transcription 
job: jobs 
ally: ally 
answer: answer 
learn: learn 
scott: scott 
album: album 
couple: couple 
label: label 
need: need 
general: general 
record: records 
version: version 
advertise: advertise 
hear: hear 
challenged: challenged 
gone: gone 
patch: patch 
f: f 
drinking: drinking 
male: male 
boot: boots 
make: make 
e: e 
bullet: bullet 
talk: talk 
friday: friday 
assistant: assistant 
individual: individual 
enjoying: enjoying 
somethin: somethin 
republic: republic 
able: able 
ultimate: ultimate 
jeff: jeff 
quarantine: quarantine 
surprised: surprised 
song: songs song 
speaks: speaks 
live: live 
mix: mix 
eivind: eivind 
licensing: licensing 
yount: yount 
anyway: anyway 
culbertson: culbertson 
music: music 
contact: contact 
especially: especially 
big: big 
double: double 
medium: media 
guitar: guitar 
blew: blew 
mean: mean 
joey: joey 
organ: organ 
collection: collection 
neon: neon 
hot: hot 
said: said 
second: second 
bryan: bryan 
saw: saw 
old: old 
annotation: annotation 
video: videos 
guess: guess 
traducci: traducci 
p: p 
made: made 
osborne: osborne 
probably: probably 
add: add 
check: check 
sign: sign 
little: little 
dangerous: dangerous 
via: via 
k: k 
demo: demo 
bitter: bitter 
might: might 
river: river 
cupid: cupid 
featured: featured 
comment: comment comments 
much: much 
outlaw: outlaw 
ask: ask 
ballad: ballad 
moi: moi 
drop: drop 
wind: wind 
heartless: heartless 
boat: boat 
rescue: rescue 
sale: sale 
universal: universal 
h: h 
ooh: ooh 
feedback: feedback 
loving: loving 
c: c 
originally: originally 
better: better 
way: way 
guide: guide 
still: still 
translation: translation translations 
top: top 
short: short 
different: different 
good: good 
august: august 
sand: sand 
fan: fans 
promote: promote 
scholar: scholars 
forum: forum 
social: social 
solo: solo 
driveway: driveway 
distinguish: distinguish 
policy: policy 
verse: verse 
etc: etc 
peach: peaches 
getting: getting 
dodged: dodged 
jimmie: jimmie 
use: use 
fact: facts 
vocalist: vocalists 
question: question 
like: like 
broken: broken 
younger: younger 
releasing: releasing 
tiktok: tiktok 
written: written 
singer: singer 
heard: heard 
genius: genius 
b: b 
chart: chart charts 
knew: knew 
repeating: repeating 
friend: friends 
southern: southern 
time: time 
full: full 
chill: chill 
x: x 
nordland: nordland 
wonderin: wonderin 
bet: bet 
girl: girl 
tok: tok 
cancel: cancel 
produced: produced 
llc: llc 
