va: va 
go: go 
player: player 
interpolation: interpolations 
ground: ground 
created: created 
transcriber: transcribers 
march: march 
given: given 
barroom: barroom 
receive: receive 
bluegrass: bluegrass 
kentucky: kentucky 
sometimes: sometimes 
mashup: mashup 
date: date 
q: q 
v: v 
release: release 
personal: personal 
twin: twin 
dancer: dancer 
classic: classic 
type: type 
devil: devil 
james: james 
hit: hit 
tonk: tonk 
reached: reached 
share: share 
morgane: morgane 
mics: mics 
sang: sang 
g: g 
line: lines 
liquor: liquor 
bit: bit 
love: love 
cover: cover covers 
got: got 
expand: expand 
high: high 
updated: updated 
minor: minor 
smooth: smooth 
night: nights night 
get: get 
sing: sing 
tag: tags 
americana: americana 
daddy: daddy 
z: z 
looked: looked 
november: november 
known: known 
duet: duet 
blue: blues 
mind: mind 
breakout: breakout 
mine: mine 
always: always 
thinking: thinking 
sweet: sweet 
interview: interview 
bold: bold 
view: view 
cause: cause 
co: co 
biggest: biggest 
arrangement: arrangement 
privacy: privacy 
singing: singing 
italic: italics 
u: us u 
diamond: diamond 
whiskey: whiskey 
brandy: brandy 
header: headers 
rescued: rescued 
information: information 
guideline: guidelines 
place: places 
cadillac: cadillac 
stay: stay 
road: road 
man: man 
contributor: contributor contributors 
many: many 
even: even 
sound: sound 
part: parts part 
understand: understand 
read: read 
stoned: stoned 
w: w 
also: also 
bottle: bottle 
ever: ever 
background: background 
soul: soul 
songwriter: songwriter 
name: name 
track: track 
steel: steel 
country: country 
dry: dry 
checking: checking 
credit: credits 
chorus: chorus 
imase: imase 
musical: musical 
etta: etta 
insight: insight 
chris: chris 
used: used 
blind: blind 
billboard: billboard 
bottom: bottom 
timberlake: timberlake 
source: source 
coe: coe 
certification: certifications 
term: terms 
felt: felt 
blame: blame 
r: r 
copyright: copyright 
outro: outro 
knowledge: knowledge 
verified: verified 
thing: things 
certified: certified 
visit: visit 
dave: dave 
sell: sell 
l: l 
search: search 
intoxicating: intoxicating 
heart: heart 
david: david 
noted: noted 
playing: playing 
waste: waste 
developer: developers 
reason: reason 
spend: spend 
poured: poured 
equation: equation 
tennessee: tennessee 
press: press 
linda: linda 
resemblance: resemblance 
well: well 
pain: pain 
cobb: cobb 
state: state 
vocal: vocals 
rather: rather 
shop: shop 
fabric: fabric 
nothin: nothin 
cma: cma 
format: format 
section: section 
ml: ml 
honky: honky 
back: back 
honey: honey 
romanized: romanized 
world: world 
wine: wine 
found: found 
band: band 
n: n 
maybe: maybe 
lyric: lyric lyrics 
show: show 
played: played 
charlottesville: charlottesville 
j: j 
artist: artists 
covered: covered 
started: started 
stapleton: stapleton 
play: play 
embed: embed 
holding: holdings 
transcription: transcription 
job: jobs 
answer: answer 
learn: learn 
far: far 
record: records 
version: version 
advertise: advertise 
gone: gone 
set: set 
f: f 
riaa: riaa 
anymore: anymore 
fire: fire 
brought: brought 
outside: outside 
e: e 
genesis: genesis 
groove: groove 
individual: individual 
hargrove: hargrove 
away: away 
warm: warm 
ultimate: ultimate 
song: songs song 
george: george 
performed: performed 
bein: bein 
fader: fader 
licensing: licensing 
could: could 
music: music 
power: power 
contact: contact 
guitar: guitar 
named: named 
traveller: traveller 
collection: collection 
nobody: nobody 
hot: hot 
said: said 
one: one 
old: old 
annotation: annotation 
major: major 
video: videos 
bluesy: bluesy 
p: p 
probably: probably 
add: add 
check: check 
sign: sign 
come: come 
favorite: favorite 
little: little 
since: since 
cry: cry 
via: via 
k: k 
might: might 
imagery: imagery 
cupid: cupid 
featured: featured 
comment: comment comments 
outlaw: outlaw 
dean: dean 
ask: ask 
ballad: ballad 
sack: sacks 
recalled: recalled 
around: around 
drop: drop 
whatever: whatever 
alternative: alternative 
movie: movie 
enjoyed: enjoyed 
waiting: waiting 
rescue: rescue 
glass: glass 
h: h 
c: c 
originally: originally 
guide: guide 
dillon: dillon 
top: top 
justin: justin 
different: different 
good: good 
promote: promote 
scholar: scholars 
forum: forum 
allan: allan 
solo: solo 
parachute: parachute 
distinguish: distinguish 
steve: steve 
policy: policy 
verse: verse 
etc: etc 
influenced: influenced 
rock: rock 
decided: decided 
perfect: perfect 
use: use 
fact: facts 
studio: studio 
vocalist: vocalists 
jones: jones 
question: question 
listened: listened 
like: like 
beyonc: beyonc 
broken: broken 
written: written 
something: something 
genius: genius 
chart: chart charts 
b: b 
hinson: hinson 
repeating: repeating 
year: years 
ironically: ironically 
guy: guys 
time: time 
x: x 
strawberry: strawberry 
pray: pray 
every: every 
cancel: cancel 
produced: produced 
llc: llc 
notoriety: notoriety 
star: stars 
award: awards 
reachin: reachin 
