go: go 
interpolate: interpolate 
rhett: rhett 
removed: removed 
street: streets 
baby: baby 
vertalingen: vertalingen 
following: following 
created: created 
transcriber: transcribers 
breathe: breathe 
course: course 
rol: rol 
aol: aol 
cheer: cheer 
tree: tree 
somehow: somehow 
nuance: nuances 
throwback: throwback 
like: likes like 
note: notes 
butch: butch 
engineer: engineer 
date: date 
wake: wake 
traducciones: traducciones 
blackmon: blackmon 
mixing: mixing 
q: q 
v: v 
nichijou: nichijou 
recording: recording 
release: release 
portugu: portugu 
defensive: defensive 
anything: anything 
personal: personal 
wrld: wrld 
twin: twin 
spanish: spanish 
shirt: shirts 
tape: tape 
bop: bop 
duomo: duomo 
record: record records 
received: received 
type: type 
tom: tom 
explained: explained 
sample: sample samples 
chikili: chikili 
session: sessions session 
white: white 
share: share 
whole: whole 
g: g 
belong: belong 
line: lines line 
never: never 
love: love 
two: two 
life: life 
tell: tell tells 
jedwill: jedwill 
got: got 
expand: expand 
high: high 
relationship: relationship 
listening: listening 
completely: completely 
get: get gets 
riley: riley 
link: link 
carlito: carlito 
e: es e 
stephen: stephen 
tag: tags 
kiwi: kiwi 
instead: instead 
z: z 
november: november 
house: house 
bout: bout 
remixes: remixes 
mine: mine 
appears: appears 
rose: rose 
came: came 
always: always 
thinking: thinking 
kagayakashiki: kagayakashiki 
brasil: brasil 
sleeping: sleeping 
bold: bold 
atv: atv 
management: management 
kidz: kidz 
view: view 
cause: cause 
co: co 
sony: sony 
wagnerville: wagnerville 
biggest: biggest 
privacy: privacy 
sophomore: sophomore 
italic: italics 
u: us u 
light: lights light 
right: right rights 
pop: pop 
rafael: rafael 
header: headers 
juice: juice 
information: information 
espa: espa 
nederland: nederlands 
guideline: guidelines 
contributor: contributor contributors 
periscope: periscope 
work: work 
even: even 
bubblegum: bubblegum 
head: head 
part: parts part 
understand: understand 
read: read 
first: first 
reacted: reacted 
w: w 
cimorelli: cimorelli 
also: also 
ever: ever 
day: day 
songwriter: songwriter 
kenny: kenny 
em: em 
seen: seen 
humor: humor 
heel: heels 
smile: smile 
whatcha: whatcha 
teddy: teddy 
track: track 
know: know 
popular: popular 
performance: performances performance 
country: country 
publishing: publishing 
phone: phone 
help: help 
upset: upset 
wrapped: wrapped 
fifteen: fifteen 
credit: credits 
chorus: chorus 
musical: musical 
insight: insight 
end: end 
anthem: anthem 
source: source 
sin: sin 
friend: friend 
certification: certifications 
believe: believe 
term: terms 
felt: felt 
blame: blame 
copyright: copyright 
r: r 
outro: outro 
knowledge: knowledge 
walker: walker 
liz: liz 
verified: verified 
thing: things 
visit: visit 
platinum: platinum 
idea: idea 
sell: sell 
typical: typical 
storyline: storyline 
l: l 
search: search 
moment: moment 
gaga: gaga 
mash: mash 
new: new 
picture: picture 
wanting: wanting 
developer: developers 
taylor: taylor 
think: think 
ligon: ligon 
overheard: overheard 
al: al 
quickly: quickly 
group: group 
press: press 
chapman: chapman 
boy: boy 
page: page 
kid: kids 
fever: fever 
cobb: cobb 
amazing: amazing 
state: state 
shop: shop 
soy: soy 
fail: fail 
going: going 
laughing: laughing 
tuesday: tuesday 
easy: easy 
find: find 
format: format 
section: section 
ml: ml 
forever: forever 
niebank: niebank 
back: back 
already: already 
world: world 
paul: paul 
ol: ol 
bench: bench 
n: n 
maybe: maybe 
lyric: lyric lyrics 
show: show 
fine: fine 
j: j 
fresh: fresh 
artist: artists 
portuguese: portuguese 
laugh: laugh 
meaning: meaning 
thought: thought 
walking: walking 
yankovic: yankovic 
looking: looking 
chitty: chitty 
aj: aj 
talking: talking 
embed: embed 
holding: holdings 
transcription: transcription 
job: jobs 
answer: answer 
learn: learn 
horse: horse 
album: album 
label: label 
producing: producing 
listen: listen 
version: version 
advertise: advertise 
oh: oh 
itis: itis 
call: call 
f: f 
monday: monday 
erika: erika 
brought: brought 
writer: writer 
finishing: finishing 
fun: fun 
tmz: tmz 
message: message 
bad: bad 
worn: worn 
sorry: sorry 
assistant: assistant 
individual: individual 
skirt: skirts 
weird: weird 
tamerlane: tamerlane 
ultimate: ultimate 
toxic: toxic 
driving: driving 
allie: allie 
song: songs song 
live: live 
saying: saying 
licensing: licensing 
yelling: yelling 
could: could 
make: makes 
music: music 
contact: contact 
big: big 
along: along 
medium: media 
nathan: nathan 
tubbie: tubbie 
uptempo: uptempo 
standing: standing 
epic: epic 
collection: collection 
tradu: tradu 
website: website 
next: next 
costell: costell 
hot: hot 
esp: esp 
remember: remember 
united: united 
change: change 
said: said 
one: one 
de: de 
bleacher: bleachers 
bmg: bmg 
nederlandse: nederlandse 
video: video videos 
annotation: annotation 
torus: tori 
basically: basically 
warner: warner 
traducci: traducci 
appreciate: appreciate 
p: p 
earworm: earworm 
orbison: orbison 
add: add 
check: check 
machine: machine 
sign: sign 
favorite: favorite 
let: let 
basic: basic 
became: became 
since: since 
cry: cry 
k: k 
might: might 
hour: hours 
tried: tried 
cupid: cupid 
billy: billy 
featured: featured 
comment: comment comments 
much: much 
style: style 
swift: swift 
say: say 
hey: hey 
daybyday: daybyday 
pasiva: pasiva 
ask: ask 
sneaker: sneakers 
kind: kind 
xx: xx 
maki: maki 
tres: tres 
drop: drop 
wrote: wrote 
room: room 
entertainment: entertainment 
bmi: bmi 
waiting: waiting 
write: write 
middle: middle 
rescue: rescue 
h: h 
fearless: fearless 
wear: wear wears 
c: c 
better: better 
way: way 
guide: guide 
translation: translation translations 
short: short 
different: different 
justin: justin 
publisher: publisher 
loved: loved 
musician: musician 
bang: bang 
bridge: bridge 
promote: promote 
jean: jeans 
scholar: scholars 
secret: secret 
tu: tu 
forum: forum 
park: park 
guy: guy 
distinguish: distinguish 
steve: steve 
story: story 
another: another 
ought: ought 
policy: policy 
verse: verse 
etc: etc 
kelly: kelly 
peach: peaches 
someone: someone 
teen: teen 
understands: understands 
explain: explain 
ft: ft 
dream: dreams 
behind: behind 
use: use 
lady: lady 
fact: facts 
vocalist: vocalists 
dj: dj 
question: question 
best: best 
broken: broken 
corp: corp 
written: written 
caption: caption 
something: something 
singer: singer 
praising: praising 
genius: genius 
b: b 
hears: hears 
repeating: repeating 
time: time 
x: x 
medley: medley 
writing: writing 
pre: pre 
went: went 
dreaming: dreaming 
door: door 
cover: covers 
chart: charts 
girl: girl 
every: every 
ur: ur 
night: night 
cancel: cancel 
produced: produced 
llc: llc 
captain: captain 
pl: pl 
vertaling: vertaling 
responded: responded 
jake: jake 
ran: ran 
sig: sig 
girlfriend: girlfriend 
cream: cream 
town: town 
really: really 
fromtheheart: fromtheheart 
greek: greek 
see: see 
peluca: peluca 
liner: liner 
dutch: dutch 
