go: go 
indie: indie 
interpolate: interpolate 
rhett: rhett 
wash: washes wash 
lucky: lucky 
baby: baby 
holophonics: holophonics 
season: seasons 
watt: watts 
ground: ground 
created: created 
transcriber: transcribers 
exhausting: exhausting 
camp: camp 
edits: edits 
peace: peace 
biggayrapper: biggayrapper 
dantdm: dantdm 
hipster: hipster 
vaccine: vaccines 
designer: designer 
throwback: throwback 
note: notes 
mashup: mashup 
red: red 
engineer: engineer 
date: date 
traducciones: traducciones 
melody: melody 
mixing: mixing 
q: q 
ugh: ugh 
wardrobe: wardrobe 
v: v 
recording: recording 
release: release 
portugu: portugu 
crazy: crazy 
personal: personal 
chalkeaters: chalkeaters 
tonight: tonight 
spanish: spanish 
twin: twin 
leave: leave 
continuous: continuous 
bop: bop 
joe: joe 
would: would 
swear: swear 
peter: peter 
home: home 
record: record records 
received: received 
type: type 
people: people 
tom: tom 
apartment: apartment 
hopefully: hopefully 
explained: explained 
outfit: outfits 
trick: trick 
sample: sample samples 
keyboard: keyboards 
colbreakz: colbreakz 
tominaga: tominaga 
band: bands 
share: share 
leading: leading 
usually: usually 
sissom: sissom 
traductions: traductions 
g: g 
line: lines 
sad: sad 
never: never 
month: month 
love: love 
declares: declares 
fifth: fifth 
trouble: trouble 
plagiarize: plagiarize 
cover: cover covers 
expand: expand 
high: high 
relationship: relationship 
pluffaduff: pluffaduff 
get: get 
call: calls call 
link: link 
lin: lin 
projection: projection 
film: film 
e: es e 
self: self 
tag: tags 
shellback: shellback 
fly: fly 
z: z 
relevant: relevant 
selling: selling 
miss: miss 
joann: joann 
remixes: remixes 
mind: mind 
costume: costume 
mine: mine 
starlight: starlight 
wilson: wilson 
hayley: hayley 
martin: martin 
always: always 
brasil: brasil 
cited: cited 
bold: bold 
kidz: kidz 
view: view 
green: green 
working: working 
cause: cause 
sony: sony 
aise: aise 
biggest: biggest 
mindless: mindless 
lovely: lovely 
ended: ended 
privacy: privacy 
screaming: screaming 
italic: italics 
u: us u 
abstract: abstract 
ai: ais aises 
synth: synth 
happy: happy 
alexis: alexis 
matt: matt 
light: lights 
digital: digital 
right: right 
pop: pop 
rafael: rafael 
header: headers 
information: information 
tiffany: tiffany 
espa: espa 
guideline: guidelines 
holland: holland 
else: else 
declan: declan 
stay: stay 
person: person 
indulgence: indulgence 
barden: barden 
contributor: contributor contributors 
erban: erban 
many: many 
even: even 
bubblegum: bubblegum 
part: parts part 
understand: understand 
triple: triple 
read: read 
first: first 
graceffa: graceffa 
w: w 
cimorelli: cimorelli 
also: also 
ever: ever 
opposite: opposite 
enough: enough 
day: day days 
background: background 
scene: scene 
involved: involved 
songwriter: songwriter 
refuse: refuses 
max: max 
programmer: programmer 
em: em 
seen: seen 
together: together 
alvord: alvord 
track: track 
know: know 
maddie: maddie 
performance: performances 
bar: bar 
weeze: weeze 
landon: landon 
country: country 
radio: radio 
everything: everything 
phone: phone 
worked: worked 
lasted: lasted 
fight: fights 
experience: experiences 
process: process 
credit: credits 
chorus: chorus 
huxley: huxley 
musical: musical 
walk: walk 
insight: insight 
tragic: tragic 
bass: bass 
end: end 
used: used 
anthem: anthem 
billboard: billboard 
source: source 
ilbert: ilbert 
certification: certifications 
parody: parody 
today: today 
term: terms 
felt: felt 
ghenea: ghenea 
sp: sp 
copyright: copyright 
r: r 
outro: outro 
coordinator: coordinator 
snow: snow 
knowledge: knowledge 
megan: megan 
gonna: gonna 
verified: verified 
thing: things 
visit: visit 
dave: dave 
nice: nice 
sell: sell 
production: production 
year: year 
austin: austin 
north: north 
l: l 
search: search 
moment: moment 
fr: fr 
mash: mash 
lot: lot 
shine: shine 
new: new 
school: school 
mastering: mastering 
noah: noah 
continue: continue 
coyne: coyne 
greg: greg 
playoff: playoffs 
hollens: hollens 
developer: developers 
taylor: taylor 
madilyn: madilyn 
rear: rear 
think: think 
complexity: complexity 
sensitive: sensitive 
boyce: boyce 
al: al 
french: french 
absolutely: absolutely 
trigwell: trigwell 
press: press 
bay: bay 
almost: almost 
studio: studios studio 
acoustic: acoustic 
well: well 
kid: kids 
pink: pink 
state: state 
shop: shop 
fail: fail 
conard: conard 
cardboard: cardboard 
air: air 
grammy: grammy 
going: going 
sydney: sydney 
varying: varying 
bella: bella 
designed: designed 
finally: finally 
find: find 
aisha: aisha 
nether: nether 
tour: tour 
format: format 
section: section 
robert: roberts 
last: last 
ml: ml 
forever: forever 
caring: caring 
back: back 
lil: lil 
treacherous: treacherous 
moving: moving 
post: post 
iscf: iscf 
world: world 
brittany: brittany 
ol: ol 
nicole: nicole 
area: areas 
lo: lo 
yeah: yeah 
n: n 
lyric: lyric lyrics 
jocelyn: jocelyn 
played: played 
brighter: brighter 
j: j 
described: described 
onto: onto 
portuguese: portuguese 
artist: artists 
single: single 
team: team 
apparition: apparitions 
fran: fran 
thought: thought 
hannah: hannah 
started: started 
reggie: reggie 
rebel: rebel 
aj: aj 
embed: embed 
holding: holdings 
transcription: transcription 
job: jobs 
breakup: breakup 
answer: answer 
quick: quick 
learn: learn 
bellas: bellas 
sarcastically: sarcastically 
backed: backed 
album: album 
holy: holy 
ex: ex 
clicked: clicked 
label: label 
seamlessly: seamlessly 
version: version 
advertise: advertise 
oh: oh 
hear: hear 
set: set sets 
boyfriend: boyfriend 
arm: arm 
f: f 
traduction: traduction 
gmpresents: gmpresents 
make: make 
message: message 
caitlin: caitlin 
whitebloom: whitebloom 
talk: talk 
michael: michael 
falling: falling 
assistant: assistant 
individual: individual 
away: away 
smosh: smosh 
eylands: eylands 
able: able 
ultimate: ultimate 
director: director 
trust: trust 
scofield: scofield 
putting: putting 
charm: charm 
song: songs song 
take: take 
hide: hide 
live: live 
time: times time 
saying: saying 
licensing: licensing 
minecraft: minecraft 
bubble: bubble 
could: could 
nomination: nomination 
begin: begin 
changed: changed 
music: music 
contact: contact 
velcro: velcro 
jayne: jayne 
big: big 
serbian: serbian 
guitar: guitar 
feel: feel 
mean: mean 
run: run 
joey: joey 
collection: collection 
anna: anna 
tradu: tradu 
remix: remix 
next: next 
andrew: andrew 
hot: hot 
united: united 
remember: remember 
victor: victor 
change: change 
said: said 
one: one 
npobu: npobu 
loana: loana 
aug: aug 
video: video videos 
cut: cut 
annotation: annotation 
loxive: loxive 
released: released 
torus: tori 
traducci: traducci 
p: p 
earworm: earworm 
made: made 
add: add 
check: check 
machine: machine 
space: space 
sign: sign 
come: come 
car: car 
telling: telling 
dodie: dodie 
k: k 
demo: demo 
reveal: reveal 
might: might 
ky: ky 
cupid: cupid 
ball: balls 
featured: featured 
comment: comment comments 
much: much 
swift: swift 
say: say 
knapp: knapp 
riff: riff 
ask: ask 
kind: kind 
true: true 
changing: changing 
tara: tara 
inferior: inferior 
grace: grace 
around: around 
pomplamoose: pomplamoose 
drop: drop 
degree: degrees 
wall: wall 
natewantstobattle: natewantstobattle 
touching: touching 
kendrick: kendrick 
portrait: portrait 
truglio: truglio 
rescue: rescue 
hate: hate 
h: h 
ooh: ooh 
tether: tether 
three: three 
stuff: stuff 
c: c 
guide: guide 
translation: translation translations 
still: still 
cooper: cooper 
different: different 
good: good 
august: august 
stopped: stopped 
split: split 
bridge: bridge 
original: original 
promote: promote 
scholar: scholars 
secret: secret 
deluxe: deluxe 
forum: forum 
whether: whether 
award: award 
park: park 
distinguish: distinguish 
shot: shot 
policy: policy 
verse: verse 
etc: etc 
kelly: kelly 
tim: tim 
peach: peaches 
cooler: cooler 
getting: getting 
teen: teen 
rock: rock 
humorous: humorous 
perfect: perfect 
screen: screen 
eric: eric 
hanes: hanes 
sure: sure 
trying: trying 
ft: ft 
beautiful: beautiful 
drive: drive 
use: use 
romantic: romantic 
fact: facts 
dance: dance 
vocalist: vocalists 
fuess: fuess 
dj: dj 
question: question 
listened: listened 
usa: usa 
like: like 
broken: broken 
hart: hart 
written: written 
conway: conway 
meticulously: meticulously 
caption: caption 
rawinthevoid: rawinthevoid 
singer: singer 
pitch: pitch 
lead: lead 
heard: heard 
genius: genius 
b: b 
recorded: recorded 
wild: wild 
knew: knew 
repeating: repeating 
friend: friends 
literally: literally 
x: x 
needed: needed 
broke: broke 
sam: sam 
medley: medley 
writing: writing 
harmony: harmony 
tell: tells 
pre: pre 
went: went 
leg: leg 
see: see 
williams: williams 
break: break 
fourth: fourth 
meant: meant 
packer: packers 
chart: charts 
girl: girl 
avenue: avenue 
night: night 
mxm: mxm 
cancel: cancel 
produced: produced 
llc: llc 
pull: pull 
john: john 
tackled: tackled 
wearing: wearing 
really: really 
huang: huang 
called: called 
definitive: definitive 
luke: luke 
guthrie: guthrie 
instrumental: instrumental 
picking: picking 
liner: liner 
