mark: mark 
rogers: rogers 
created: created 
transcriber: transcribers 
johnny: johnny 
somehow: somehow 
draw: draw 
ridin: ridin 
engineer: engineer 
date: date 
gate: gate 
q: q 
v: v 
later: later 
release: release 
want: want 
personal: personal 
twin: twin 
home: home 
beat: beat 
type: type 
people: people 
keyboard: keyboards 
grundman: grundman 
losing: losing 
fool: fool 
share: share 
g: g 
line: lines 
never: never 
love: love 
creek: creek 
issued: issued 
sens: senses 
tell: tell 
got: got 
expand: expand 
alone: alone 
get: get 
high: highs 
glenn: glenn 
tag: tags 
z: z 
somebody: somebody 
open: open 
album: albums album 
pleasin: pleasin 
always: always 
bold: bold 
view: view 
biggest: biggest 
eagle: eagles 
privacy: privacy 
mandolin: mandolin 
italic: italics 
u: us u 
diamond: diamond diamonds 
henley: henley 
table: table 
header: headers 
information: information 
alisan: alisan 
guideline: guidelines 
man: man 
contributor: contributor contributors 
even: even 
part: parts part 
heart: hearts 
understand: understand 
read: read 
hunger: hunger 
first: first 
texas: texas 
w: w 
also: also 
day: day 
background: background 
deutsch: deutsch 
songwriter: songwriter 
kenny: kenny 
drum: drums 
name: name 
gimme: gimme 
impetus: impetus 
track: track 
know: know 
country: country 
string: string 
credit: credits 
chorus: chorus 
musical: musical 
debut: debut 
insight: insight 
bass: bass 
frey: frey 
association: association 
source: source 
control: control 
long: long 
reason: reasons 
ronstadt: ronstadt 
term: terms 
although: although 
copyright: copyright 
r: r 
snow: snow 
knowledge: knowledge 
verified: verified 
thing: things 
crawford: crawford 
visit: visit 
sell: sell 
foot: feet 
l: l 
search: search 
billie: billie 
shine: shine 
cash: cash 
reprise: reprise 
feeling: feeling 
mastering: mastering 
meisner: meisner 
sample: samples 
developer: developers 
western: western 
sunrise: sunrise 
fence: fences 
prison: prison 
ball: ball 
tequila: tequila 
press: press 
boy: boy 
linda: linda 
project: project 
acoustic: acoustic 
well: well 
pain: pain 
vocal: vocals 
shop: shop 
decksperado: decksperado 
langley: langley 
banjo: banjo 
tour: tour 
format: format 
section: section 
hard: hard 
ml: ml 
asylum: asylum 
go: goes 
andy: andy 
seventy: seventies 
world: world 
appeared: appeared 
n: n 
bernie: bernie 
lyric: lyric lyrics 
spear: spears 
howard: howard 
doolin: doolin 
fine: fine 
j: j 
one: ones one 
artist: artists 
single: single 
walking: walking 
samia: samia 
twenty: twenty 
talking: talking 
embed: embed 
holding: holdings 
transcription: transcription 
job: jobs 
lucas: lucas 
sky: sky 
learn: learn 
canyon: canyon 
label: label 
record: records 
version: version 
diana: diana 
advertise: advertise 
oh: oh 
f: f 
jim: jim 
west: west 
upon: upon 
brought: brought 
writer: writer 
e: e 
john: johns 
michael: michael 
assistant: assistant 
individual: individual 
away: away 
phonographic: phonographic 
able: able 
wintertime: wintertime 
ultimate: ultimate 
ger: ger 
yudai: yudai 
queen: queen 
may: may 
driving: driving 
hurt: hurt 
song: songs song 
sun: sun 
licensing: licensing 
numerous: numerous 
american: american 
chenoweth: chenoweth 
music: music 
contact: contact 
laura: laura 
late: late 
guitar: guitar 
named: named 
glyn: glyn 
norman: norman 
collection: collection 
concert: concert 
image: images 
hot: hot 
compilation: compilation 
second: second 
certain: certain 
old: old 
annotation: annotation 
dobro: dobro 
video: videos 
p: p 
add: add 
check: check 
sign: sign 
come: come 
let: let 
harmonica: harmonica 
since: since 
kristin: kristin 
desperado: desperado 
k: k 
bitter: bitter 
might: might 
laid: laid 
cupid: cupid 
ohno: ohno 
featured: featured 
comment: comment comments 
outlaw: outlaw 
rainin: rainin 
ask: ask 
kind: kind 
drop: drop 
nighttime: nighttime 
rescue: rescue 
h: h 
c: c 
better: better 
guide: guide 
april: april 
krall: krall 
electric: electric 
school: schools 
top: top 
different: different 
jo: jo 
promote: promote 
scholar: scholars 
forum: forum 
neil: neil 
conjures: conjures 
laurel: laurel 
distinguish: distinguish 
dan: dan 
policy: policy 
verse: verse 
etc: etc 
peach: peaches 
getting: getting 
rock: rock 
randy: randy 
use: use 
ed: ed 
fact: facts 
vocalist: vocalists 
question: question 
low: lows 
best: best 
contributed: contributed 
mtgremy: mtgremy 
like: like 
broken: broken 
younger: younger 
written: written 
rainbow: rainbow 
gimmes: gimmes 
dalton: dalton 
singer: singer 
lead: lead 
genius: genius 
b: b 
recorded: recorded 
repeating: repeating 
seems: seems 
southern: southern 
time: time 
x: x 
cold: cold 
however: however 
porter: porter 
williams: williams 
bet: bet 
cover: covers 
chart: charts 
funny: funny 
night: night 
cancel: cancel 
produced: produced 
llc: llc 
freedom: freedom 
london: london 
kilgour: kilgour 
saturday: saturday 
arranger: arranger 
instrumental: instrumental 
leadon: leadon 
