la: la 
honor: honor 
baby: baby 
created: created 
march: march 
spent: spent 
breathe: breathe 
transcriber: transcribers 
featuring: featuring 
describes: describes 
side: side 
wasted: wasted 
engineer: engineer 
date: date 
traducciones: traducciones 
mixing: mixing 
q: q 
hope: hope 
god: god 
v: v 
recording: recording 
release: release 
portugu: portugu 
personal: personal 
tonight: tonight 
contains: contains 
spanish: spanish 
leave: leave 
twin: twin 
bersetzung: bersetzung 
record: record records 
type: type 
june: june 
people: people 
feature: features 
keyboard: keyboards 
white: white 
share: share 
traductions: traductions 
making: making 
mr: mr 
g: g 
line: lines 
belong: belong 
never: never 
vocal: vocal vocals 
love: love 
josh: josh 
former: former 
tell: tell 
synthesizer: synthesizer 
got: got 
expand: expand 
swore: swore 
listening: listening 
eviri: eviri 
get: get gets 
reinterpret: reinterpret 
clean: clean 
folklore: folklore 
wall: walls 
e: es e 
stephen: stephen 
tag: tags 
thematic: thematic 
perfectly: perfectly 
z: z 
cried: cried 
always: always 
brasil: brasil 
bold: bold 
view: view 
die: die 
cause: cause 
aise: aise 
biggest: biggest 
privacy: privacy 
sophomore: sophomore 
kaufman: kaufman 
italic: italics 
u: us u 
county: county 
bathroom: bathroom 
ai: ais aises 
happy: happy 
underneath: underneath 
midnight: midnight 
right: right 
pop: pop 
header: headers 
information: information 
espa: espa 
graffiti: graffiti 
guideline: guidelines 
contributor: contributor contributors 
work: work 
even: even 
part: parts part 
understand: understand 
read: read 
first: first 
w: w 
also: also 
day: day 
background: background 
deutsch: deutsch 
songwriter: songwriter 
programmer: programmer 
em: em 
drum: drums drum 
road: roads 
together: together 
track: track 
know: know knows 
country: country 
worked: worked 
watched: watched 
morris: morris 
marenmorris: marenmorris 
fifteen: fifteen 
credit: credits 
percussion: percussion 
chorus: chorus 
pavement: pavement 
musical: musical 
insight: insight 
grin: grin 
perform: perform 
bass: bass 
used: used 
child: child 
scooter: scooter 
lied: lied 
billboard: billboard 
source: source 
amount: amount 
long: long 
prevodi: prevodi 
today: today 
maren: maren 
julian: julian 
term: terms 
polskie: polskie 
copyright: copyright 
r: r 
outro: outro 
knowledge: knowledge 
verified: verified 
visit: visit 
sell: sell 
instagram: instagram 
rediscover: rediscover 
low: low 
l: l 
taylorswift: taylorswift 
feeling: feeling 
mastering: mastering 
stone: stones 
sample: samples 
greg: greg 
developer: developers 
addition: addition 
taylor: taylor 
bersetzungen: bersetzungen 
al: al 
french: french 
group: group 
press: press 
incredible: incredible 
dessner: dessner 
turkish: turkish 
project: project 
lost: lost 
tire: tires 
acoustic: acoustic 
well: well 
srpski: srpski 
shop: shop 
air: air 
bella: bella 
similar: similar 
find: find 
dollar: dollar 
format: format 
section: section 
ml: ml 
last: last 
leaked: leaked 
forever: forever 
lyrically: lyrically 
rk: rk 
aaron: aaron 
world: world 
found: found 
ol: ol 
n: n 
ending: ending 
lyric: lyric lyrics 
stall: stalls 
fine: fine 
j: j 
debuted: debuted 
artist: artists 
portuguese: portuguese 
single: single 
fran: fran 
vida: vida 
unreleased: unreleased 
embed: embed 
holding: holdings 
viva: viva 
transcription: transcription 
job: jobs 
magyar: magyar 
wish: wish 
answer: answer 
fairytale: fairytale 
learn: learn 
horse: horse 
album: album 
label: label 
turn: turn 
burg: burg 
evermore: evermore 
version: version 
advertise: advertise 
commentary: commentary 
bye: bye 
rowe: rowe 
pocket: pockets pocket 
pleasure: pleasure 
f: f 
traduction: traduction 
connected: connected 
personnel: personnel 
stain: stain 
sorry: sorry 
helping: helping 
merrill: merrill 
individual: individual 
reminds: reminds 
republic: republic 
phonographic: phonographic 
able: able 
ultimate: ultimate 
mark: marks 
song: songs song 
elvira: elvira 
licensing: licensing 
music: music 
contact: contact 
serbian: serbian 
guitar: guitar 
blasko: blasko 
collection: collection 
tradu: tradu 
remix: remix 
hot: hot 
change: change 
ford: ford 
said: said 
umaczenia: umaczenia 
one: one 
rain: rain 
old: old 
annotation: annotation 
released: released 
traducci: traducci 
video: videos 
p: p 
tear: tears 
add: add 
check: check 
english: english 
sign: sign 
come: come 
untouchable: untouchable 
harmonica: harmonica 
via: via 
k: k 
might: might 
christopher: christopher 
cupid: cupid 
featured: featured 
comment: comment comments 
much: much 
held: held 
swift: swift 
hey: hey 
ask: ask 
eastern: eastern 
scratch: scratch 
enjoy: enjoy 
sok: sok 
met: met 
carusoe: carusoe 
collaborate: collaborate 
around: around 
drop: drop 
past: past 
breath: breath 
dried: dried 
enjoyed: enjoyed 
melted: melted 
recently: recently 
lived: lived 
universal: universal 
h: h 
fearless: fearless 
traded: traded 
c: c 
translation: translation translations 
way: way 
guide: guide 
still: still 
april: april 
smiled: smiled 
electric: electric 
different: different 
muddy: muddy 
loved: loved 
german: german 
umaczenie: umaczenie 
vault: vault 
agust: agust 
promote: promote 
scholar: scholars 
learned: learned 
forum: forum 
distinguish: distinguish 
story: story 
policy: policy 
verse: verse 
etc: etc 
hand: hands 
fall: fall 
eric: eric 
randy: randy 
ft: ft 
superstar: superstar 
use: use 
studio: studio 
fact: facts 
vocalist: vocalists 
kurstin: kurstin 
week: week 
question: question 
best: best 
like: like 
broken: broken 
releasing: releasing 
written: written 
slick: slick 
polski: polski 
singer: singer 
genius: genius 
b: b 
repeating: repeating 
prevod: prevod 
time: time 
x: x 
jump: jump 
piano: piano 
worst: worst 
door: door 
break: break 
meant: meant 
chart: charts 
every: every 
jonathan: jonathan 
cancel: cancel 
produced: produced 
llc: llc 
freedom: freedom 
burned: burned 
deutsche: deutsche 
really: really 
element: elements 
lover: lover 
instrumental: instrumental 
see: see 
