q: q 
number: number 
created: created 
world: world 
guitar: guitar 
know: know 
joan: joan 
rescue: rescue 
til: til 
tom: tom 
search: search 
baby: baby 
could: could 
hey: hey 
kevin: kevin 
g: g 
circle: circle 
december: december 
vocalist: vocalists 
wanna: wanna 
might: might 
sasha: sasha 
r: r 
clearwater: clearwater 
sunny: sunny 
born: born 
contributor: contributor 
watson: watson 
billboard: billboard 
genius: genius 
understand: understand 
nelson: nelson 
storm: storm 
even: even 
jeevas: jeevas 
raining: raining 
c: c 
tyler: tyler 
cold: cold 
credit: credits 
scholar: scholars 
getting: getting 
wish: wish 
record: records 
paula: paula 
seventy: seventies 
arranged: arranged 
tsui: tsui 
live: live 
type: type 
chart: charts chart 
source: source 
learn: learn 
norby: norby 
move: move 
album: album 
percussion: percussion 
someone: someone 
stu: stu 
keyboard: keyboards 
sell: sell 
one: one 
doug: doug 
seen: seen 
etc: etc 
embed: embed 
chameleon: chameleon 
calm: calm 
featured: featured 
beautiful: beautiful 
guideline: guidelines 
southern: southern 
track: track 
boney: boney 
peaked: peaked 
country: country 
tell: tell 
hideaway: hideaway 
moorer: moorer 
racer: racer 
horn: horn 
b: b 
slow: slow 
w: w 
shinin: shinin 
forever: forever 
alan: alan 
biggest: biggest 
knowledge: knowledge 
revival: revival 
day: days day 
bold: bold 
smokie: smokie 
awakening: awakening 
twin: twin 
yareed: yareed 
cancel: cancel 
verified: verified 
advertise: advertise 
part: parts part 
creedence: creedence 
mr: mr 
dr: dr 
reaching: reaching 
sam: sam 
stop: stop 
f: f 
transcription: transcription 
rain: rain 
standard: standard 
stewart: stewart 
produced: produced 
promote: promote 
thought: thought 
doctor: doctors 
ultimate: ultimate 
hoffman: hoffman 
ballad: ballad 
year: year 
song: songs song 
broken: broken 
dale: dale 
tag: tags 
clifford: clifford 
always: always 
tonight: tonight 
allison: allison 
tony: tony 
rude: rude 
gunn: gunn 
rus: russ 
header: headers 
press: press 
bass: bass 
holding: holdings 
lumineers: lumineers 
read: read 
privacy: privacy 
insight: insight 
z: z 
stone: stone 
like: like 
job: jobs 
answer: answer 
ago: ago 
alternative: alternative 
spin: spin 
corey: corey 
charted: charted 
performance: performances performance 
band: band 
question: question 
line: lines 
sun: sun 
bright: bright 
steve: steve 
studio: studios 
visit: visit 
serious: serious 
individual: individual 
contact: contact 
comment: comments comment 
molina: molina 
llc: llc 
date: date 
shop: shop 
format: format 
wally: wally 
pendulum: pendulum 
soft: soft 
march: march 
fast: fast 
said: said 
drop: drop 
root: roots 
music: music 
highest: highest 
add: add 
water: water 
jett: jett 
ml: ml 
v: v 
e: e 
wonder: wonder 
mastering: mastering 
yesterday: yesterday 
john: john 
rod: rod 
different: different 
fogerty: fogerty 
heider: heider 
jim: jim 
label: label 
vocal: vocals 
u: us u 
cilie: cilie 
songwriter: songwriter 
voice: voice 
chorus: chorus 
imagery: imagery 
information: information 
expand: expand 
right: right 
want: want 
forum: forum 
cupid: cupid 
factory: factory 
copyright: copyright 
sample: samples sample 
yeah: yeah 
fantasy: fantasy 
long: long 
h: h 
breaking: breaking 
written: written 
hard: hard 
policy: policy 
n: n 
bonnie: bonnie 
teenage: teenage 
comin: comin 
phyllotaxis: phyllotaxis 
release: release 
ever: ever 
l: l 
sign: sign 
willie: willie 
ramones: ramones 
artist: artists 
ft: ft 
collection: collection 
p: p 
arthur: arthur 
reacting: reacting 
inner: inner 
way: way 
fanclub: fanclub 
canada: canada 
verse: verse 
pagan: pagan 
taylor: taylor 
licensing: licensing 
share: share 
transcriber: transcribers 
mashup: mashup 
jackson: jackson 
hi: hi 
distinguish: distinguish 
geez: geez 
johnny: johnny 
cook: cook 
cover: covers 
view: view 
arrangement: arrangement 
x: x 
faber: faber 
drum: drums 
repeating: repeating 
guide: guide 
rolling: rolling 
annotation: annotation 
carey: carey 
term: terms 
lyric: lyric lyrics 
version: version 
sailor: sailor 
check: check 
really: really 
piano: piano 
fact: facts 
personal: personal 
say: say 
italic: italics 
faceplants: faceplants 
singer: singer 
mixing: mixing 
minuteman: minutemen 
j: j 
single: singles single 
use: use 
section: section 
mango: mango 
impending: impending 
group: group 
told: told 
time: time 
video: videos 
interpolate: interpolate 
alphamega: alphamega 
developer: developers 
love: love 
allen: allen 
lament: lament 
hot: hot 
magazine: magazine 
eight: eight 
engineer: engineer 
drive: drive 
released: released 
also: also 
rock: rock 
ask: ask 
recorded: recorded 
peach: peaches 
breakup: breakup 
go: goes 
musical: musical 
cash: cash 
sin: sin 
gary: gary 
k: k 
