feeling: feelings feeling 
desperate: desperate 
q: q 
covered: covered 
think: think 
thought: thoughts 
around: around 
change: change 
created: created 
together: together 
world: world 
guitar: guitar 
il: il 
chair: chair 
know: know 
carter: carter 
work: works 
hit: hit 
word: words 
rescue: rescue 
support: support 
faith: faith 
wrote: wrote 
search: search 
intro: intro 
overdubs: overdubs 
relic: relic 
could: could 
ai: aises ais 
hart: hart 
sweetest: sweetest 
nashville: nashville 
g: g 
away: away 
yunk: yunk 
vocalist: vocalists 
included: included 
elegie: elegie 
might: might 
gore: gore 
r: r 
contributor: contributor contributors 
callmekevin: callmekevin 
sevendust: sevendust 
farthing: farthing 
harm: harm 
mine: mine 
sent: sent 
tn: tn 
cletus: cletus 
lost: lost 
billboard: billboard 
genius: genius 
understand: understand 
see: see 
nelson: nelson 
girlfriend: girlfriend 
new: new 
los: los 
tear: tears tear 
people: people 
pill: pill 
end: end 
even: even 
crown: crown 
legend: legend 
universal: universal 
dedicated: dedicated 
aise: aise 
unspeakable: unspeakable 
c: c 
tyler: tyler 
db: db 
era: era 
performed: performed 
cold: cold 
start: start 
credit: credits 
pick: pick 
scholar: scholars 
residence: residence 
troubled: troubled 
rosanne: rosanne 
place: place 
letting: letting 
becomes: becomes 
failing: failing 
mellotron: mellotron 
listened: listened 
made: made 
still: still 
felt: felt 
traduction: traduction 
hall: hall 
type: type 
sane: sane 
hormel: hormel 
chart: charts chart 
power: power 
iron: iron 
goose: goose 
translation: translation translations 
source: source 
control: control 
last: last 
sounding: sounding 
bronson: bronson 
learn: learn 
slava: slava 
process: process 
sounded: sounded 
novo: novo 
year: years 
campbell: campbell 
sound: sounds 
repair: repair 
cabin: cabin 
stanknasty: stanknasty 
someone: someone 
sell: sell 
however: however 
scratch: scratch 
one: one 
self: self 
realises: realises 
etc: etc 
embed: embed 
recording: recording recordings 
mode: mode 
trauma: trauma 
iv: iv 
fergie: fergie 
house: house 
sing: sing 
featured: featured 
beautiful: beautiful 
americana: americana 
watching: watching 
taomi: taomi 
guideline: guidelines 
genre: genre 
angeles: angeles 
harris: harris 
first: first 
studio: studio 
track: track 
klondike: klondike 
decided: decided 
jesus: jesus 
ferguson: ferguson 
country: country 
rick: rick 
b: b 
penny: penny 
nobody: nobody 
w: w 
taco: taco 
forever: forever 
heard: heard 
biggest: biggest 
wear: wear 
knowledge: knowledge 
would: would 
christian: christian 
parody: parody 
bold: bold 
melody: melody 
organ: organ 
either: either 
worried: worried 
twin: twin 
shotgun: shotgun 
medium: medium 
cancel: cancel 
become: become 
sense: sense 
sick: sick 
verified: verified 
kvety: kvety 
advertise: advertise 
letter: letter 
part: parts part 
bleak: bleak 
bit: bit 
arkangel: arkangel 
management: management 
hope: hope 
trailer: trailer 
harrowing: harrowing 
possibly: possibly 
producer: producer 
mr: mr 
heroin: heroin 
sam: sam 
lonesome: lonesome 
isolated: isolated 
strong: strong 
along: along 
probably: probably 
mix: mix 
radically: radically 
transcription: transcription 
f: f 
tre: tre 
disputed: disputed 
traductions: traductions 
produced: produced 
positive: positive 
promote: promote 
teeth: teeth 
struggle: struggle 
lyrically: lyrically 
art: art 
rely: rely 
rubin: rubin 
upon: upon 
outlaw: outlaw 
ultimate: ultimate 
suit: suit 
night: night 
thorn: thorns 
tried: tried 
al: al 
wind: winds 
ballad: ballad 
artist: artist artists 
agreed: agreed 
gun: gun 
song: songs song 
give: give 
broken: broken 
tag: tags 
coldnima: coldnima 
cicierega: cicierega 
daughter: daughter 
always: always 
tench: tench 
movie: movie 
turco: turco 
silence: silence 
matter: matter 
pain: pain 
header: headers 
suicidal: suicidal 
figurative: figurative 
droogie: droogie 
press: press 
holding: holdings 
hydracoque: hydracoque 
died: died 
originally: originally 
mike: mike 
another: another 
slastic: slastic 
delivering: delivering 
wow: wow 
read: read 
privacy: privacy 
asked: asked 
without: without 
insight: insight 
becoming: becoming 
mile: miles 
z: z 
stone: stone 
awfully: awfully 
like: like 
wifebeatmane: wifebeatmane 
vicarpi: vicarpi 
job: jobs 
pure: pure 
send: send 
every: every 
flattered: flattered 
answer: answer 
alternative: alternative 
mason: mason 
reflecting: reflecting 
bell: bell 
question: question 
cypher: cypher 
line: lines line 
wolverine: wolverine 
hole: hole 
stained: stained 
sheet: sheet 
visit: visit 
leaving: leaving 
make: make 
form: form 
try: try 
thing: thing 
inch: inch 
individual: individual 
alone: alone 
contact: contact 
comment: comments comment 
nail: nails 
llc: llc 
date: date 
shop: shop 
kobalt: kobalt 
dis: diss 
engineering: engineering 
bridge: bridge 
format: format 
ruined: ruined 
mark: mark 
doctor: doctor 
old: old 
march: march 
said: said 
drop: drop 
focus: focus 
music: music 
lukimea: lukimea 
add: add 
brussel: brussel 
childhood: childhood 
water: water 
sealnoon: sealnoon 
three: three 
af: af 
rio: rio 
ml: ml 
denzel: denzel 
death: death 
jingle: jingle 
planeta: planeta 
pop: pop 
acoustic: acoustic 
v: v 
smokey: smokey 
real: real 
e: e 
trent: trent 
next: next 
recommended: recommended 
september: september 
reflects: reflects 
john: john 
find: find 
different: different 
somehow: somehow 
label: label 
u: us u 
drama: drama 
coyote: coyote 
november: november 
street: streets 
vino: vino 
meaning: meaning 
chorus: chorus 
voice: voice 
information: information 
head: head 
expand: expand 
remember: remember 
right: right rights 
smaller: smaller 
depeche: depeche 
ayuwoki: ayuwoki 
publisher: publisher 
face: face 
forum: forum 
cupid: cupid 
series: series 
filmed: filmed 
beneath: beneath 
witchz: witchz 
bump: bumps 
copyright: copyright 
disappear: disappear 
sample: samples sample 
meet: meet 
fran: fran 
h: h 
everyone: everyone 
written: written 
possible: possible 
hard: hard 
policy: policy 
gay: gay 
june: june 
case: case 
done: done 
n: n 
video: video videos 
legendary: legendary 
collection: collections collection 
hung: hung 
release: release 
pot: pot 
ever: ever 
l: l 
ended: ended 
piece: piece 
sign: sign 
fortnite: fortnite 
idea: idea 
reinterpreted: reinterpreted 
benzel: benzel 
month: months 
today: today 
burned: burned 
hurt: hurt 
gashi: gashi 
ft: ft 
krasavec: krasavec 
barber: barber 
empire: empire 
p: p 
lot: lot 
liar: liar 
cannot: cannot 
way: way 
american: american 
verse: verse 
familiar: familiar 
taylor: taylor 
keep: keep 
malfatto: malfatto 
licensing: licensing 
share: share 
romanek: romanek 
transcriber: transcribers 
turn: turn 
rose: rose 
nine: nine 
comedy: comedy 
desperado: desperado 
plus: plus 
arlovol: arlovol 
bedroom: bedroom 
come: comes 
dirt: dirt 
distinguish: distinguish 
reznor: reznor 
kp: kpss 
recently: recently 
wife: wife 
director: director 
stage: stage 
johnny: johnny 
cover: covers cover 
million: million 
cried: cried 
view: view 
french: french 
everything: everything 
clout: clout 
came: came 
x: x 
zbieral: zbieral 
repeating: repeating 
guide: guide 
rolling: rolling 
else: else 
annotation: annotation 
johnson: johnson 
big: big 
show: show 
term: terms 
dark: dark 
laredo: laredo 
shaggy: shaggy 
proud: proud 
killval: killval 
lyric: lyric lyrics 
version: version 
adult: adult 
cassidy: cassidy 
time: times time 
totally: totally 
powerful: powerful 
staying: staying 
check: check 
really: really 
hear: hear 
piano: piano 
built: built 
logan: logan 
fact: facts 
personal: personal 
italic: italics 
ray: ray 
catharsis: catharsis 
man: man 
highway: highway 
language: language 
mixing: mixing 
david: david 
full: full 
sting: sting 
sincerity: sincerity 
seeing: seeing 
j: j 
cry: cry 
menestrel: menestrel 
danny: danny 
use: use 
chuck: chuck 
section: section 
needle: needle 
ascap: ascap 
single: single 
including: including 
classic: classics 
performance: performance 
watched: watched 
later: later 
welling: welling 
group: group 
told: told 
maybe: maybe 
friend: friend 
interpolate: interpolate 
developer: developers 
chlapec: chlapec 
love: love 
strongly: strongly 
feel: feel 
selection: selection 
hot: hot 
stain: stains 
boy: boy 
outro: outro 
monster: monster 
put: put 
anymore: anymore 
life: life 
compilation: compilation 
engineer: engineer 
neil: neil 
gimmicky: gimmicky 
bar: bars 
released: released 
also: also 
isabela: isabela 
kill: kill 
saw: saw 
responded: responded 
ask: ask 
recorded: recorded 
peach: peaches 
master: master 
benmont: benmont 
br: br 
go: goes 
musical: musical 
upset: upset 
remixes: remixes 
dragon: dragon 
breath: breath 
addiction: addiction 
let: let 
cash: cash 
lachow: lachow 
chris: chris 
k: k 
issue: issues 
retains: retains 
health: health 
de: de 
