q: q 
created: created 
together: together 
world: world 
guitar: guitar 
rescue: rescue 
sometimes: sometimes 
isosine: isosine 
search: search 
intro: intro 
kidz: kidz 
g: g 
vocalist: vocalists 
light: light 
wanna: wanna 
might: might 
godbey: godbey 
r: r 
third: third 
best: best 
contributor: contributor contributors 
ca: ca 
publishing: publishing 
write: write 
genius: genius 
billboard: billboard 
understand: understand 
los: los 
even: even 
morning: morning 
refrain: refrain 
santiago: santiago 
vitamin: vitamin 
universal: universal 
danja: danja 
c: c 
performed: performed 
start: start 
timbaland: timbaland 
credit: credits 
scholar: scholars 
fauntleroy: fauntleroy 
hop: hop 
force: force 
muzik: muzik 
fluid: fluid 
record: records 
name: name 
ooh: ooh 
still: still 
live: live 
type: type 
chart: charts 
source: source 
looking: looking 
cape: cape 
learn: learn 
process: process 
bengineer: bengineer 
album: album 
sound: sounds 
conway: conway 
warner: warner 
sell: sell 
midnight: midnight 
one: one 
sedano: sedano 
elliott: elliott 
caught: caught 
assistant: assistant 
etc: etc 
embed: embed 
matty: matty 
recording: recording 
blue: blue 
featured: featured 
nothin: nothin 
americana: americana 
guideline: guidelines 
heart: heart 
angeles: angeles 
first: first 
studio: studio studios 
track: track 
necessarily: necessarily 
transgression: transgressions 
country: country 
tell: tell 
b: b 
string: string 
w: w 
biggest: biggest 
knowledge: knowledge 
bold: bold 
melody: melody 
twin: twin 
something: something 
cancel: cancel 
verified: verified 
pre: pre 
going: going 
advertise: advertise 
scalladosis: scalladosis 
part: parts part 
direction: direction 
justin: justin 
vb: vb 
bit: bit 
producer: producer 
bluegrass: bluegrass 
plan: plan 
filthy: filthy 
f: f 
transcription: transcription 
city: city 
produced: produced 
tennman: tennman 
experimental: experimental 
promote: promote 
klein: klein 
montana: montana 
call: call 
hip: hips 
know: knows 
two: two 
ultimate: ultimate 
alright: alright 
danjahandz: danjahandz 
song: songs song 
broken: broken 
tag: tags 
bmi: bmi 
cma: cma 
via: via 
ben: ben 
acclaimed: acclaimed 
always: always 
nike: nike 
tonight: tonight 
production: production 
higher: higher 
grammy: grammy 
sauce: sauce 
rance: rance 
blast: blast 
kutch: kutch 
volumeeventureslic: volumeeventureslic 
header: headers 
press: press 
holding: holdings 
thing: things 
contemporary: contemporary 
th: th 
read: read 
privacy: privacy 
insight: insight 
z: z 
molotov: molotov 
like: like 
job: jobs 
phonographic: phonographic 
answer: answer 
annual: annual 
go: go 
ken: ken 
timberlake: timberlake 
question: question 
whoa: whoa 
line: lines 
electronic: electronic 
stuff: stuff 
visit: visit 
mixed: mixed 
dreamer: dreamers 
individual: individual 
contact: contact 
comment: comments comment 
llc: llc 
instrumental: instrumental 
date: date 
shop: shop 
format: format 
nominee: nominees 
drop: drop 
root: roots 
music: music 
wave: wave 
remix: remix 
add: add 
mullins: mullins 
electro: electro 
ml: ml 
pop: pop 
arranger: arranger 
acoustic: acoustic 
v: v 
e: e 
get: get 
additional: additional 
mastering: mastering 
james: james 
different: different 
breeze: breeze 
work: work 
vocal: vocal 
u: us u 
rca: rca 
songwriter: songwriter 
chorus: chorus 
jam: jam 
information: information 
expand: expand 
tune: tunes 
right: right rights 
publisher: publisher 
want: want 
forum: forum 
dave: dave 
cupid: cupid 
pond: pond 
young: young 
copyright: copyright 
sample: samples sample 
take: take 
yeah: yeah 
h: h 
middle: middle 
everyone: everyone 
stapleton: stapleton 
written: written 
hard: hard 
policy: policy 
jungle: jungle 
n: n 
video: video videos 
folk: folk 
release: release 
writing: writing 
l: l 
sign: sign 
sammy: sammy 
award: awards 
bop: bop 
greatest: greatest 
artist: artists 
mhmm: mhmm 
ft: ft 
worsnop: worsnop 
interlude: interlude 
livin: livin 
collection: collection 
creative: creative 
contrast: contrast 
p: p 
chance: chance 
lot: lot 
feature: features 
way: way 
post: post 
verse: verse 
tucky: tucky 
fourth: fourth 
licensing: licensing 
share: share 
transcriber: transcribers 
sesac: sesac 
guy: guys 
flannel: flannel 
previous: previous 
reservoir: reservoir 
rhythm: rhythm 
distinguish: distinguish 
cocktail: cocktail 
kid: kids 
cover: covers 
view: view 
collaboration: collaboration 
came: came 
x: x 
repeating: repeating 
guide: guide 
annotation: annotation 
harmony: harmony 
term: terms 
land: land 
lyric: lyric lyrics 
ives: ives 
version: version 
featuring: featuring 
check: check 
really: really 
hear: hear 
piano: piano 
fact: facts 
personal: personal 
say: say says 
italic: italics 
singer: singer 
man: man 
went: went 
summer: summer 
mixing: mixing 
j: j 
single: singles single 
danny: danny 
use: use 
section: section 
ascap: ascap 
lujan: lujan 
performance: performance 
group: group 
bbx: bbx 
maybe: maybe 
interpolate: interpolate 
developer: developers 
supply: supplies 
great: great 
love: love 
strongly: strongly 
wood: woods 
nonstop: nonstop 
official: official 
hot: hot 
nothing: nothing 
sean: sean 
medium: media 
help: help 
engineer: engineer 
released: released 
everybody: everybody 
also: also 
influenced: influenced 
rising: rising 
ask: ask 
recorded: recorded 
peach: peaches 
minimal: minimal 
red: red 
musical: musical 
january: january 
remixes: remixes 
somewhere: somewhere 
chris: chris 
k: k 
quartet: quartet 
duo: duo 
