sleeve: sleeve 
q: q 
thou: thou 
falling: falling 
liar: liar 
dixon: dixon 
studio: studio studios 
track: track 
directed: directed 
background: background 
question: question 
pontare: pontare 
post: post 
created: created 
world: world 
verse: verse 
sky: sky 
pournouri: pournouri 
line: lines 
country: country 
know: know 
licensing: licensing 
six: six 
share: share 
transcriber: transcribers 
scandipop: scandipop 
veronica: veronica 
b: b 
rescue: rescue 
jesse: jesse 
rediscover: rediscover 
visit: visit 
string: string 
search: search 
instalok: instalok 
w: w 
make: make 
brasil: brasil 
individual: individual 
proibido: proibido 
scandinavia: scandinavia 
contact: contact 
comment: comments comment 
biggest: biggest 
light: lights 
dub: dub 
hey: hey 
knowledge: knowledge 
war: war 
instrumental: instrumental 
kidz: kidz 
date: date 
sverige: sverige 
llc: llc 
shop: shop 
extended: extended 
come: comes 
distinguish: distinguish 
nashville: nashville 
g: g 
interscope: interscope 
bold: bold 
shot: shot 
blood: blood 
vocalist: vocalists 
need: need 
kid: kids 
road: road 
shame: shame 
believe: believe 
twin: twin 
tradu: tradu 
format: format 
family: family 
imagining: imagining 
cover: covers cover 
might: might 
view: view 
cancel: cancel 
important: important 
gracie: gracie 
r: r 
verified: verified 
davi: davi 
vincent: vincent 
going: going 
x: x 
drop: drop 
bottom: bottom 
music: music 
morgan: morgan 
repeating: repeating 
guide: guide 
remix: remix 
advertise: advertise 
add: add 
contributor: contributor contributors 
annotation: annotation 
putaclic: putaclic 
water: water 
part: parts part 
far: far 
growing: growing 
term: terms 
electro: electro 
hay: hay 
ml: ml 
salem: salem 
dear: dear 
hope: hope 
lyric: lyric lyrics 
version: version 
bruthur: bruthur 
pop: pop 
genius: genius 
wake: wake 
understand: understand 
v: v 
e: e es 
check: check 
vietnam: vietnam 
portugu: portugu 
neal: neal 
hear: hear 
translation: translations translation 
bluegrass: bluegrass 
people: people 
wonder: wonder 
fact: facts 
thicker: thicker 
even: even 
personal: personal 
arash: arash 
italic: italics 
older: older 
endless: endless 
true: true 
vitamin: vitamin 
hot: hot 
different: different 
transcription: transcription 
dan: dan 
f: f 
c: c 
wallen: wallen 
syn: syn 
produced: produced 
j: j 
break: break 
credit: credits 
vocal: vocals 
agust: agust 
use: use 
u: us u 
scholar: scholars 
promote: promote 
gabe: gabe 
avicii: avicii 
section: section 
viewer: viewer 
bakersfield: bakersfield 
edit: edit 
voice: voice 
chorus: chorus 
call: call 
performance: performance 
art: art 
information: information 
expand: expand 
progressive: progressive 
tyminski: tyminski 
upon: upon 
instrumentation: instrumentation 
boy: boys boy 
video: videos video 
interpolate: interpolate 
still: still 
forum: forum 
ultimate: ultimate 
developer: developers 
cupid: cupid 
type: type 
livinho: livinho 
song: song songs 
love: love 
canyon: canyons 
tried: tried 
al: al 
sample: samples sample 
copyright: copyright 
chart: charts 
lose: lose 
inspired: inspired 
english: english 
take: take 
broken: broken 
nothing: nothing 
anthem: anthem 
long: long 
cole: cole 
source: source 
tag: tags 
zerator: zerator 
learn: learn 
cheney: cheney 
berywam: berywam 
help: help 
spab: spab 
dad: dad 
always: always 
uncredited: uncredited 
h: h 
engineer: engineer 
written: written 
run: run 
movie: movie 
policy: policy 
also: also 
lay: lay 
wartime: wartime 
n: n 
addicted: addicted 
protective: protective 
someone: someone 
sell: sell 
oh: oh 
cappellino: cappellino 
release: release 
header: headers 
fakir: fakir 
one: one 
em: em 
mc: mc 
ask: ask 
l: l 
soggy: soggy 
home: home 
sister: sister 
portuguese: portuguese 
edom: edom 
sign: sign 
sweet: sweet 
hell: hell 
recorded: recorded 
press: press 
holding: holdings 
died: died 
etc: etc 
radio: radio 
embed: embed 
project: project 
doghouse: doghouse 
another: another 
recording: recording 
schram: schram 
maggio: maggio 
musical: musical 
remixes: remixes 
bop: bop 
read: read 
october: october 
dance: dance 
artist: artists 
house: house 
privacy: privacy 
featured: featured 
california: california 
ft: ft 
insight: insight 
fruto: fruto 
chris: chris 
z: z 
brother: brother 
k: k 
like: like 
quartet: quartet 
collection: collection 
guideline: guidelines 
job: jobs 
singer: singers 
heart: heart 
p: p 
teach: teaches 
answer: answer 
sternbaum: sternbaum 
