q: q 
tamerlane: tamerlane 
track: track 
slowing: slowing 
way: way 
touch: touch 
question: question 
ghost: ghosts 
hillary: hillary 
created: created 
world: world 
verse: verse 
line: lines 
country: country 
spotify: spotify 
licensing: licensing 
chappell: chappell 
tell: tell 
uk: uk 
share: share 
bottle: bottle 
transcriber: transcribers 
rose: rose 
b: b 
studio: studios 
rescue: rescue 
rush: rush 
visit: visit 
search: search 
w: w 
perfume: perfume 
much: much 
individual: individual 
contact: contact 
crazy: crazy 
comment: comments comment 
mckenna: mckenna 
biggest: biggest 
knowledge: knowledge 
tennessee: tennessee 
llc: llc 
date: date 
shop: shop 
endurance: endurance 
nashville: nashville 
distinguish: distinguish 
g: g 
bold: bold 
hair: hair 
vocalist: vocalists 
bryan: bryan 
wanna: wanna 
lip: lips 
twin: twin 
format: format 
might: might 
view: view 
laugh: laugh 
cancel: cancel 
r: r 
verified: verified 
everything: everything 
right: rights 
x: x 
drop: drop 
music: music 
advertise: advertise 
repeating: repeating 
guide: guide 
alpha: alpha 
harry: harry 
thinking: thinking 
annotation: annotation 
add: add 
contributor: contributor contributors 
part: parts part 
big: big 
term: terms 
sheet: sheets 
ml: ml 
publishing: publishing 
lyric: lyric lyrics 
version: version 
pop: pop 
genius: genius 
understand: understand 
acoustic: acoustic 
v: v 
got: got 
real: real 
taste: taste 
check: check 
e: e 
get: get 
fact: facts 
even: even 
town: town 
personal: personal 
september: september 
metropolis: metropolis 
italic: italics 
gold: gold 
lindsey: lindsey 
crush: crush 
different: different 
transcription: transcription 
universal: universal 
f: f 
lori: lori 
bbc: bbc 
c: c 
magic: magic 
little: little 
produced: produced 
j: j 
performed: performed 
single: singles 
givin: givin 
credit: credits 
cause: cause 
opry: opry 
use: use 
u: us u 
promote: promote 
scholar: scholars 
november: november 
section: section 
liz: liz 
ascap: ascap 
hate: hate 
chorus: chorus 
know: knows 
information: information 
expand: expand 
group: group 
maybe: maybe 
ole: ole 
admit: admit 
video: videos 
want: want 
two: two 
forum: forum 
publisher: publisher 
ultimate: ultimate 
developer: developers 
cupid: cupid 
type: type 
song: song songs 
love: love 
smile: smile 
tried: tried 
copyright: copyright 
chart: charts 
perfomance: perfomance 
cover: cover 
yeah: yeah 
mind: mind 
broken: broken 
blomerati: blomerati 
source: source 
long: long 
hot: hot 
tag: tags 
bmi: bmi 
sleep: sleep 
learn: learn 
drown: drown 
h: h 
always: always 
style: styles 
corp: corp 
lord: lord 
written: written 
concord: concord 
warner: warner 
blonde: blonde 
grone: grone 
policy: policy 
also: also 
n: n 
london: london 
whisperin: whisperin 
sell: sell 
grand: grand 
oh: oh 
release: release 
midnight: midnight 
header: headers 
bed: bed 
ask: ask 
beginning: beginning 
l: l 
recorded: recorded 
press: press 
sign: sign 
holding: holdings 
peach: peaches 
etc: etc 
embed: embed 
bad: bad 
peace: peace 
musical: musical 
girl: girl 
artist: artists 
privacy: privacy 
featured: featured 
bmg: bmg 
insight: insight 
z: z 
k: k 
like: like 
collection: collection 
job: jobs 
guideline: guidelines 
heart: heart 
p: p 
pullin: pullin 
