held: held 
uhm: uhm 
go: go 
paul: paul 
q: q 
covered: covered 
father: father 
track: track 
around: around 
dreamed: dreamed 
developer: developers 
question: question 
created: created 
world: world 
verse: verse 
davis: davis 
lineman: lineman 
line: lines 
country: country 
tell: tell 
know: know 
licensing: licensing 
share: share 
dog: dog 
rick: rick 
transcriber: transcribers 
laughter: laughter 
b: b 
walk: walk 
rescue: rescue 
minute: minutes 
visit: visit 
wrote: wrote 
search: search 
w: w 
make: make 
actually: actually 
uh: uh 
alone: alone 
much: much 
individual: individual 
contact: contact 
gentle: gentle 
comment: comments comment 
could: could 
wichita: wichita 
easy: easy 
knowledge: knowledge 
biggest: biggest 
llc: llc 
instrumental: instrumental 
charles: charles 
date: date 
shop: shop 
g: g 
distinguish: distinguish 
come: comes come 
bold: bold 
away: away 
vocalist: vocalists 
son: son 
left: left 
wanna: wanna 
johnny: johnny 
listening: listening 
twin: twin 
format: format 
claim: claim 
might: might 
cried: cried 
view: view 
cancel: cancel 
please: please 
r: r 
verified: verified 
popular: popular 
right: rights 
x: x 
drop: drop 
music: music 
pleasure: pleasure 
repeating: repeating 
guide: guide 
advertise: advertise 
vida: vida 
add: add 
contributor: contributor contributors 
else: else 
annotation: annotation 
part: parts part 
big: big 
chattanooga: chattanooga 
term: terms 
ml: ml 
sold: sold 
dear: dear 
publishing: publishing 
lyric: lyric lyrics 
version: version 
genius: genius 
understand: understand 
redemption: redemption 
time: times time 
apr: aprs 
v: v 
got: got 
check: check 
e: e 
viva: viva 
peermusic: peermusic 
get: get 
fact: facts 
even: even 
personal: personal 
stop: stop 
sunshine: sunshine 
italic: italics 
toxic: toxic 
singer: singer 
different: different 
transcription: transcription 
man: man 
f: f 
never: never 
c: c 
awoke: awoke 
jimmie: jimmie 
produced: produced 
salty: salty 
j: j 
break: break 
credit: credits 
pick: pick 
well: well 
use: use 
promote: promote 
u: us u 
loved: loved 
scholar: scholars 
november: november 
section: section 
lokeigh: lokeigh 
chorus: chorus 
gray: gray 
performance: performance 
information: information 
rubin: rubin 
head: head 
expand: expand 
donovan: donovan 
unearthed: unearthed 
historian: historians 
sugar: sugar 
publisher: publisher 
video: videos 
want: want 
mistaken: mistaken 
made: made 
alright: alright 
two: two 
forum: forum 
icarus: icarus 
ultimate: ultimate 
type: type 
night: night 
cupid: cupid 
song: song songs 
love: love 
defiance: defiance 
copyright: copyright 
sample: samples sample 
feel: feel 
chart: charts 
iron: iron 
infatuation: infatuation 
take: take 
tune: tune 
broken: broken 
nothing: nothing 
mind: mind 
cover: cover 
source: source 
hot: hot 
interpretation: interpretations 
huge: huge 
outro: outro 
tag: tags 
bmi: bmi 
early: early 
la: la 
learn: learn 
anymore: anymore 
loving: loving 
shattered: shattered 
sky: skies 
always: always 
list: list 
mitchell: mitchell 
care: care 
stopped: stopped 
h: h 
written: written 
dream: dreams 
hard: hard 
policy: policy 
also: also 
lay: lay 
spoken: spoken 
n: n 
noting: noting 
cindy: cindy 
rock: rock 
rice: rice 
folk: folk 
sell: sell 
oh: oh 
release: release 
happy: happy 
header: headers 
one: one 
short: short 
ask: ask 
l: l 
recorded: recorded 
press: press 
sign: sign 
holding: holdings 
hit: hits 
etc: etc 
embed: embed 
arm: arms 
another: another 
bowed: bowed 
nice: nice 
musical: musical 
let: let 
today: today 
read: read 
artist: artists 
cash: cash 
privacy: privacy 
featured: featured 
sleeping: sleeping 
insight: insight 
z: z 
good: good 
like: like 
collection: collection 
job: jobs 
k: k 
guideline: guidelines 
babe: babe 
p: p 
worth: worth 
