feeling: feelings 
treated: treated 
q: q 
think: think 
around: around 
gap: gap 
change: change 
fine: fine 
created: created 
rule: rules 
world: world 
besides: besides 
guitar: guitar 
know: know 
mean: mean 
phone: phone 
rescue: rescue 
wrote: wrote 
whole: whole 
search: search 
tim: tim 
could: could 
title: title 
contribute: contribute 
haunted: haunted 
g: g 
instrumentals: instrumentals 
december: december 
fellow: fellow 
away: away 
vocalist: vocalists 
might: might 
grant: grant 
added: added 
r: r 
third: third 
warning: warnings 
kiss: kiss 
night: nights 
contributor: contributor contributors 
gossip: gossip 
slurring: slurring 
far: far 
mine: mine 
acing: acing 
dear: dear 
write: write 
genius: genius 
understand: understand 
swift: swift 
see: see 
people: people 
even: even 
floor: floor 
girl: girls girl 
sonically: sonically 
c: c 
usually: usually 
impressed: impressed 
test: tests 
credit: credits 
scholar: scholars 
guess: guess 
grow: grow 
record: records 
name: name 
blind: blind 
live: live 
type: type 
chart: charts 
fire: fire 
multiple: multiple 
ten: ten 
translation: translation translations 
source: source 
orchestral: orchestral 
last: last 
better: better 
played: played 
learn: learn 
gone: gone 
year: years year 
album: album 
mickelson: mickelson 
percussion: percussion 
someone: someone 
sell: sell 
oh: oh 
age: age 
beef: beef 
seen: seen 
etc: etc 
embed: embed 
blue: blue 
match: matches 
featured: featured 
revenge: revenge 
ignored: ignored 
issue: issue 
mention: mention 
doll: doll 
good: good 
guideline: guidelines 
heart: heart 
paul: paul 
track: track 
background: background 
fly: fly 
country: country 
b: b 
spark: sparks 
teen: teen 
losing: losing 
w: w 
website: website 
biggest: biggest 
knowledge: knowledge 
wilson: wilson 
would: would 
day: days 
need: need 
bold: bold 
eric: eric 
game: game games 
bryan: bryan 
twin: twin 
look: look 
shared: shared 
cancel: cancel 
sick: sick 
verified: verified 
going: going 
advertise: advertise 
pickin: pickin 
part: parts part 
expert: expert 
amos: amos 
playing: playing 
mayer: mayer 
eye: eyes 
saying: saying 
sorry: sorry 
empty: empty 
town: town 
f: f 
transcription: transcription 
rain: rain 
never: never 
produced: produced 
vulnerable: vulnerable 
promote: promote 
chapman: chapman 
throughout: throughout 
two: two 
lifeless: lifeless 
ultimate: ultimate 
praying: praying 
al: al 
ballad: ballad ballads 
sims: sims 
reply: replies 
song: songs song 
give: give 
traitor: traitors 
broken: broken 
tag: tags 
always: always 
list: list 
tonight: tonight 
alex: alex 
called: called 
relationship: relationship 
happy: happy 
header: headers 
catch: catch 
press: press 
bass: bass 
twisted: twisted 
holding: holdings 
mike: mike 
another: another 
contemporary: contemporary 
th: th 
read: read 
putting: putting 
privacy: privacy 
dry: dry 
insight: insight 
footstep: footsteps 
z: z 
statement: statement 
stone: stone 
like: like 
job: jobs 
handle: handle 
wondering: wondering 
send: send 
answer: answer 
notably: notably 
go: go 
performance: performances performance 
meadow: meadows 
question: question 
streak: streak 
line: lines line 
developed: developed 
hole: hole 
high: high 
visit: visit 
half: half 
synthesizer: synthesizer 
individual: individual 
espa: espa 
contact: contact 
collaborated: collaborated 
comment: comments comment 
llc: llc 
date: date 
shop: shop 
pushing: pushing 
conveys: conveys 
bridge: bridge 
format: format 
technique: technique 
said: said 
fast: fast 
paper: paper 
priority: priority 
drop: drop 
music: music 
add: add 
heller: heller 
presumptuous: presumptuous 
three: three 
directly: directly 
nathan: nathan 
ml: ml 
regret: regret 
shining: shining 
pop: pop 
used: used 
skin: skin 
v: v 
e: e 
firework: fireworks 
get: get 
sidoti: sidoti 
john: john 
different: different 
reflection: reflection 
purposefully: purposefully 
label: label 
cause: cause 
well: well 
u: us u 
songwriter: songwriter 
chorus: chorus 
blame: blame 
changed: changed 
information: information 
disregarded: disregarded 
expand: expand 
desire: desire 
nineteen: nineteen 
blurry: blurry 
wing: wings 
speak: speak 
want: want 
forum: forum 
cupid: cupid 
young: young 
humiliated: humiliated 
copyright: copyright 
accused: accused 
take: take 
mother: mother 
long: long 
stay: stay 
ol: ol 
enchanted: enchanted 
h: h 
stopped: stopped 
kind: kind 
sort: sort 
written: written 
policy: policy 
n: n 
rabbit: rabbit 
release: release 
ever: ever 
l: l 
home: home 
sign: sign 
chess: chess 
story: story 
month: months 
public: public 
fall: fall 
burned: burned 
artist: artists 
reference: references 
darken: darken 
others: others 
collection: collection 
replied: replied 
revolved: revolved 
p: p 
back: back 
mark: marks 
traducci: traducci 
paint: paint 
machine: machine 
way: way 
verse: verse 
taylor: taylor 
sky: sky 
venting: venting 
keep: keep 
licensing: licensing 
dress: dress 
negative: negative 
share: share 
transcriber: transcribers 
turn: turn 
distinguish: distinguish 
emotional: emotional 
wrong: wrong 
everyday: everyday 
cover: covers 
cried: cried 
view: view 
sad: sad 
everything: everything 
x: x 
repeating: repeating 
guide: guide 
rolling: rolling 
annotation: annotation 
else: else 
big: big 
frustration: frustration 
term: terms 
dark: dark 
lyric: lyric lyrics 
version: version 
adult: adult 
staying: staying 
check: check 
really: really 
hear: hear 
lived: lived 
fact: facts 
personal: personal 
say: say 
italic: italics 
thick: thick 
singer: singer 
went: went 
reaction: reaction 
j: j 
use: use 
spanish: spanish 
loved: loved 
section: section 
egomaniac: egomaniac 
including: including 
later: later 
maybe: maybe 
video: videos 
developer: developers 
tired: tired 
angel: angel 
love: love 
person: person 
hot: hot 
optimism: optimism 
magazine: magazine 
mind: mind 
outro: outro 
put: put 
life: life 
took: took 
tommy: tommy 
obvious: obvious 
run: run 
innocent: innocent 
released: released 
also: also 
rock: rock 
glamour: glamour 
short: short 
ask: ask 
peach: peaches 
keeping: keeping 
sutton: sutton 
swore: swore 
email: email 
musical: musical 
let: let 
counting: counting 
october: october 
traducciones: traducciones 
somewhere: somewhere 
known: known 
k: k 
anything: anything 
messed: messed 
