q: q 
around: around 
created: created 
world: world 
guitar: guitar 
bieber: bieber 
rescue: rescue 
heldens: heldens 
search: search 
intro: intro 
upcoming: upcoming 
must: must 
hey: hey 
war: war 
ai: aises ais 
meant: meant 
g: g 
bersetzung: bersetzung 
december: december 
interpolation: interpolations 
away: away 
vocalist: vocalists 
included: included 
respond: respond 
might: might 
leaked: leaked 
added: added 
r: r 
license: license 
contributor: contributor contributors 
koen: koen 
shock: shock 
olivia: olivia 
leak: leaks leak 
buy: buy 
fan: fans 
genius: genius 
understand: understand 
new: new 
end: end 
hide: hide 
even: even 
weight: weight 
polish: polish 
aise: aise 
reddit: reddit 
c: c 
school: school 
usually: usually 
credit: credits 
scholar: scholars 
ooh: ooh 
umaczenie: umaczenie 
made: made 
traduction: traduction 
type: type 
chart: charts 
lose: lose 
english: english 
snoop: snoop 
translation: translation translations 
source: source 
last: last 
learn: learn 
walka: walka 
sell: sell 
lil: lil 
oh: oh 
however: however 
gun: guns 
one: one 
deutsche: deutsche 
serf: serves 
etc: etc 
revealed: revealed 
embed: embed 
atlanta: atlanta 
fact: fact facts 
proven: proven 
rk: rk 
featured: featured 
nothin: nothin 
guideline: guidelines 
appeared: appeared 
track: track 
country: country 
tell: tell 
b: b 
w: w 
forever: forever 
biggest: biggest 
knowledge: knowledge 
would: would 
bold: bold 
redditor: redditor 
snippet: snippet 
twin: twin 
cancel: cancel 
verified: verified 
going: going 
advertise: advertise 
part: parts part 
justin: justin 
sold: sold 
difference: difference 
rodrigo: rodrigo 
producer: producer 
killxaki: killxaki 
stop: stop 
bersetzungen: bersetzungen 
f: f 
transcription: transcription 
many: many 
florida: florida 
traductions: traductions 
produced: produced 
promote: promote 
hate: hate 
speculate: speculate 
melt: melt 
two: two 
ultimate: ultimate 
camp: camp 
song: songs song 
controversy: controversy 
broken: broken 
august: august 
team: team 
tag: tags 
righteous: righteous 
always: always 
polskie: polskie 
wrld: wrld 
sauce: sauce 
na: nas 
cunningham: cunningham 
happy: happy 
header: headers 
press: press 
holding: holdings 
fully: fully 
another: another 
read: read 
privacy: privacy 
insight: insight 
z: z 
dogg: dogg 
like: like 
job: jobs 
dude: dude 
answer: answer 
key: key 
modern: modern 
go: go 
removebeforeflight: removebeforeflight 
voss: voss 
turkish: turkish 
question: question 
line: lines 
unreleased: unreleased 
ix: ix 
studio: studios 
confirmed: confirmed 
visit: visit 
replaced: replaced 
chord: chords 
individual: individual 
contact: contact 
comment: comments comment 
llc: llc 
shop: shop 
driver: drivers 
broke: broke 
format: format 
old: old 
drop: drop 
wmashup: wmashup 
music: music 
remix: remix 
drowzee: drowzee 
globe: globes 
add: add 
rd: rd 
thankful: thankful 
three: three 
eviri: eviri 
ml: ml 
pop: pop 
acoustic: acoustic 
v: v 
e: e 
instagram: instagram 
september: september 
john: john 
different: different 
deutsch: deutsch 
fun: fun 
u: us u 
contained: contained 
chorus: chorus 
information: information 
expand: expand 
laroi: laroi 
forum: forum 
rap: rap 
cupid: cupid 
copyright: copyright 
sample: samples 
stay: stay 
emo: emo 
fran: fran 
care: care 
h: h 
everyone: everyone 
written: written 
german: german 
policy: policy 
n: n 
folk: folk 
release: release 
l: l 
sign: sign 
eminem: eminem 
trippie: trippie 
project: project 
kid: kid 
ending: ending 
artist: artists 
ft: ft 
collection: collection 
p: p 
mess: mess 
back: back 
umaczenia: umaczenia 
post: post 
verse: verse 
licensing: licensing 
share: share 
transcriber: transcribers 
mashup: mashup 
tracklist: tracklist 
prod: prod 
distinguish: distinguish 
wrong: wrong 
juice: juice 
seven: seven 
cover: covers 
view: view 
french: french 
x: x 
drum: drums 
repeating: repeating 
guide: guide 
annotation: annotation 
loaded: loaded 
heavy: heavy 
term: terms 
lyric: lyric lyrics 
version: version 
xxxtentacion: xxxtentacion 
featuring: featuring 
check: check 
demo: demo 
piano: piano 
personal: personal 
say: say 
italic: italics 
redd: redd 
mixing: mixing 
j: j 
use: use 
section: section 
latest: latest 
passed: passed 
group: group 
vibe: vibes 
socialize: socialize 
maybe: maybe 
xxx: xxx 
developer: developers 
video: videos 
interpolate: interpolate 
love: love 
official: official 
hot: hot 
put: put 
life: life 
engineer: engineer 
ine: ine 
also: also 
news: news 
saw: saw 
em: em 
ask: ask 
recorded: recorded 
peach: peaches 
bad: bad 
musical: musical 
remixes: remixes 
twenty: twenty 
k: k 
polski: polski 
