q: q 
sadie: sadie 
think: think 
perform: perform 
howard: howard 
around: around 
change: change 
fine: fine 
number: number 
created: created 
tryin: tryin 
together: together 
world: world 
guitar: guitar 
know: know 
glass: glasses 
actress: actress 
lyin: lyin 
tour: tour 
begin: begins begin 
bordone: bordone 
rescue: rescue 
massive: massive 
til: til 
support: support 
minute: minutes minute 
wrote: wrote 
search: search 
front: front 
brasil: brasil 
lover: lover lovers 
celesta: celesta 
could: could 
ai: aises ais 
contribute: contribute 
hart: hart 
happened: happened 
g: g 
needed: needed 
interpolation: interpolations 
vocalist: vocalists 
tossing: tossing 
light: light 
christopher: christopher 
might: might 
string: strings 
york: york 
r: r 
oath: oath 
best: best 
seemingly: seemingly 
soundcheck: soundcheck 
night: nights night 
folklore: folklore 
street: street 
contributor: contributor contributors 
bet: bet 
srpski: srpski 
showed: showed 
drawer: drawer 
thinkin: thinkin 
soldier: soldier 
cruel: cruel 
dear: dear 
bone: bones 
put: puts 
fan: fans 
lost: lost 
professional: professional 
genius: genius 
understand: understand 
swift: swift 
new: new 
los: los 
josh: josh 
even: even 
weight: weight 
present: present 
bein: bein 
aise: aise 
c: c 
rough: rough 
era: era 
performed: performed 
cold: cold 
kept: kept 
credit: credits 
scholar: scholars 
getting: getting 
place: place 
swear: swear 
record: records 
name: name 
almost: almost 
mellotron: mellotron 
supposed: supposed 
secret: secret 
made: made 
still: still 
felt: felt 
tribute: tribute 
traduction: traduction 
jump: jumps 
live: live 
taught: taught 
tore: tore 
type: type 
react: react 
example: examples 
listener: listener 
chart: charts 
scarf: scarf 
ten: ten 
white: white 
translation: translation translations 
reyes: reyes 
customer: customer 
source: source 
last: last 
riksm: riksm 
better: better 
learn: learn 
returning: returning 
dad: dad 
gone: gone 
jon: jon 
dancin: dancin 
album: album 
gut: gut 
conway: conway 
initially: initially 
percussion: percussion 
sell: sell 
oh: oh 
age: age 
one: one 
rehearsal: rehearsals 
elliott: elliott 
assistant: assistant 
self: self 
wind: wind 
etc: etc 
embed: embed 
recording: recording 
picking: picking 
blue: blue 
bout: bout 
house: house 
featured: featured 
beautiful: beautiful 
sized: sized 
four: four 
good: good 
edition: edition 
brooklyn: brooklyn 
guideline: guidelines 
sher: sher 
pare: pare 
dylan: dylan 
randy: randy 
marquez: marquez 
angeles: angeles 
first: first 
studio: studio studios 
skippin: skippin 
track: track 
okay: okay 
memory: memories 
fly: fly 
flute: flute 
country: country 
keychain: keychain 
couple: couple 
tell: tell 
cheek: cheeks 
evident: evident 
b: b 
walk: walk 
nobody: nobody 
w: w 
sippin: sippin 
forever: forever 
much: much 
die: die 
bittersweet: bittersweet 
michael: michael 
biggest: biggest 
reflect: reflect 
knowledge: knowledge 
steady: steady 
would: would 
day: days day 
bold: bold 
melody: melody 
organ: organ 
affair: affair 
shame: shame 
twin: twin 
hawk: hawk 
shared: shared 
cancel: cancel 
verified: verified 
hammond: hammond 
pre: pre 
going: going 
advertise: advertise 
vida: vida 
stair: stairs 
latte: lattes 
part: parts part 
impact: impact 
jimmy: jimmy 
masterpiece: masterpiece 
ad: ad 
tee: tee 
heavily: heavily 
playing: playing 
trailer: trailer 
cross: cross 
swearin: swearin 
stern: stern 
viva: viva 
portugu: portugu 
reaching: reaching 
brien: brien 
regarded: regarded 
town: town 
leaf: leaves 
making: making 
f: f 
transcription: transcription 
many: many 
e: es e 
feeling: feeling 
programmer: programmer 
norsk: norsk 
come: come 
never: never 
punch: punch 
libbing: libbing 
maim: maim 
magic: magic 
little: little 
city: city 
traductions: traductions 
produced: produced 
promote: promote 
singin: singin 
door: door 
call: call 
jack: jack 
reached: reached 
lyrically: lyrically 
art: art 
end: ends 
saxophone: saxophone 
bryce: bryce 
interview: interview 
throughout: throughout 
two: two 
lifeless: lifeless 
fallon: fallon 
lucky: lucky 
ultimate: ultimate 
rid: rid 
beat: beat 
effacing: effacing 
promise: promise 
al: al 
ballad: ballad 
dust: dust 
song: songs song 
broken: broken 
turning: turning 
car: car 
team: team 
reminiscent: reminiscent 
intensity: intensity 
tag: tags 
via: via 
wurlitzer: wurlitzer 
always: always 
fifth: fifth 
tonight: tonight 
turnin: turnin 
counter: counter 
snow: snow 
called: called 
relationship: relationship 
wide: wide 
liner: liner 
state: state 
grave: grave 
eyed: eyed 
deluxe: deluxe 
header: headers 
vertaling: vertaling 
bed: bed 
portuguese: portuguese 
press: press 
bass: bass 
holding: holdings 
hell: hell 
lauren: lauren 
week: week 
emlyn: emlyn 
electric: electric 
lovely: lovely 
paralyzed: paralyzed 
thing: things thing 
theme: themes 
contemporary: contemporary 
photo: photo 
note: notes 
read: read 
privacy: privacy 
asked: asked 
reminds: reminds 
tragedy: tragedy 
insight: insight 
z: z 
somethin: somethin 
like: like 
job: jobs 
phonographic: phonographic 
willin: willin 
watch: watch 
every: every 
answer: answer 
receive: receive 
alternative: alternative 
turkish: turkish 
performance: performances 
enough: enough 
band: band 
question: question 
rabenold: rabenold 
rowe: rowe 
joke: jokes 
line: lines line 
oversettelse: oversettelse 
strawberry: strawberry 
casually: casually 
bottle: bottle 
dutch: dutch 
gautier: gautier 
starring: starring 
visit: visit 
cream: cream 
gonna: gonna 
half: half 
five: five 
synthesizer: synthesizer 
bruise: bruise 
chord: chords 
kitchen: kitchen 
alone: alone 
individual: individual 
espa: espa 
claimed: claimed 
message: message 
comment: comments comment 
contact: contact 
behind: behind 
grace: grace 
llc: llc 
date: date 
erban: erban 
shop: shop 
melodically: melodically 
subdued: subdued 
united: united 
caus: caus 
barren: barren 
ex: ex 
tellin: tellin 
scene: scenes 
left: left 
bridge: bridge 
believe: believe 
broke: broke 
format: format 
tradu: tradu 
scared: scared 
innocence: innocence 
shine: shine 
old: old 
paper: paper 
said: said 
farsi: farsi 
drop: drop 
joined: joined 
vault: vault 
music: music 
winter: winter 
honest: honest 
add: add 
mail: mail 
bathroom: bathroom 
three: three 
patriarchy: patriarchy 
jake: jake 
explained: explained 
ml: ml 
death: death 
ice: ice 
pop: pop 
riddleberger: riddleberger 
used: used 
sisk: sisk 
holy: holy 
skin: skin 
hidden: hidden 
noted: noted 
real: real 
acoustic: acoustic 
v: v 
get: get 
baritone: baritone 
smell: smells 
saccharine: saccharine 
mastering: mastering 
plaid: plaid 
older: older 
reflects: reflects 
actor: actor 
john: john 
find: find 
different: different 
accolade: accolades 
original: original 
fun: fun 
starlight: starlight 
specific: specific 
somehow: somehow 
label: label 
story: stories 
cause: cause 
break: break 
vocal: vocal 
well: well 
u: us u 
air: air 
november: november 
backed: backed 
bolder: bolder 
knew: knew 
songwriter: songwriter 
nederlandse: nederlandse 
chorus: chorus 
flame: flame 
ghenea: ghenea 
evan: evan 
ran: ran 
future: future 
changed: changed 
information: information 
expand: expand 
republic: republic 
remember: remember 
frame: frame 
speak: speak 
fuck: fuck 
dead: dead 
want: want 
forum: forum 
trouble: trouble 
cupid: cupid 
serbian: serbian 
pond: pond 
antonoff: antonoff 
moment: moment 
copyright: copyright 
sample: samples 
personnel: personnel 
vulture: vulture 
mother: mother 
round: round 
yeah: yeah 
charmed: charmed 
long: long 
stay: stay 
ol: ol 
worst: worst 
la: la 
smith: smith 
fran: fran 
bitter: bitter 
h: h 
kind: kind 
pulse: pulse 
sort: sort 
middle: middle 
written: written 
karaoke: karaoke 
lady: lady 
policy: policy 
n: n 
video: video videos 
folk: folk 
widely: widely 
release: release 
writing: writing 
ever: ever 
l: l 
evermore: evermore 
home: home 
sister: sister 
piece: piece pieces 
building: building 
sign: sign 
idea: idea 
past: past 
hearing: hearing 
gyllenhaal: gyllenhaal 
sacred: sacred 
film: film 
month: months 
girl: girl 
kid: kid 
fall: fall 
helped: helped 
artist: artists 
norwegian: norwegian 
maple: maple 
collection: collection 
babe: babe 
p: p 
back: back 
held: held 
gaze: gaze 
traducci: traducci 
pattern: pattern 
paint: paint 
needy: needy 
fell: fell 
vitriolic: vitriolic 
verse: verse 
taylor: taylor 
fourth: fourth 
keep: keep 
licensing: licensing 
share: share 
transcriber: transcribers 
rose: rose 
nederland: nederlands 
bokm: bokm 
refrigerator: refrigerator 
previous: previous 
wondered: wondered 
forget: forget 
coffee: coffee coffees 
distinguish: distinguish 
hair: hair 
ronan: ronan 
fallin: fallin 
glistened: glistened 
weepin: weepin 
cover: covers 
view: view 
prayer: prayer 
double: double 
french: french 
sad: sad 
everything: everything 
x: x 
drum: drums drum 
repeating: repeating 
guide: guide 
shirt: shirt 
rather: rather 
commentary: commentary 
horse: horse 
else: else 
annotation: annotation 
show: show 
shard: shards 
buried: buried 
term: terms 
upstate: upstate 
late: late 
lyric: lyric lyrics 
version: version 
see: sees 
comparison: comparisons 
adult: adult 
party: party 
russian: russian 
got: got 
check: check 
co: co 
really: really 
hear: hear 
emotive: emotive 
piano: piano 
tragic: tragic 
fact: facts 
personal: personal 
say: say 
italic: italics 
laura: laura 
singer: singer 
went: went 
ground: ground 
man: man 
mixing: mixing 
david: david 
j: j 
ar: ar 
lookin: lookin 
use: use 
spanish: spanish 
loved: loved 
section: section 
liz: liz 
though: though 
metaphor: metaphors 
wrenching: wrenching 
watched: watched 
prevod: prevod 
told: told 
time: time 
maybe: maybe 
treacherous: treacherous 
merrill: merrill 
interpolate: interpolate 
developer: developers 
inspiration: inspiration 
love: love 
vertalingen: vertalingen 
feel: feel 
rooney: rooney 
official: official 
hot: hot 
picture: picture 
mind: mind 
nothing: nothing 
runnin: runnin 
sean: sean 
outro: outro 
hutchinson: hutchinson 
life: life 
took: took 
engineer: engineer 
earworm: earworm 
bobby: bobby 
run: run 
drive: drive 
crumpled: crumpled 
everybody: everybody 
also: also 
writer: writer 
rock: rock 
autumn: autumn 
em: em 
walked: walked 
short: short 
ask: ask 
askin: askin 
recorded: recorded 
peach: peaches 
sweet: sweet 
breakup: breakup 
whose: whose 
key: keys 
go: goes 
red: red 
began: began 
rare: rare 
musical: musical 
upset: upset 
remixes: remixes 
closer: closer 
traducciones: traducciones 
jewel: jewel 
dj: dj 
twenty: twenty 
started: started 
prevodi: prevodi 
disposition: disposition 
sink: sink 
known: known 
slide: slide 
ball: ball 
k: k 
