q: q 
think: think 
magazine: magazines 
created: created 
world: world 
guitar: guitar 
know: know 
rescue: rescue 
wrote: wrote 
search: search 
brasil: brasil 
lover: lover 
hey: hey 
ai: aises ais 
likely: likely 
g: g 
bersetzung: bersetzung 
december: december 
interpolation: interpolations 
vocalist: vocalists 
wanna: wanna 
might: might 
r: r 
srpski: srpski 
contributor: contributor contributors 
magyar: magyar 
cowboy: cowboy 
dessner: dessner 
coney: coney 
buy: buy 
genius: genius 
understand: understand 
swift: swift 
see: see 
romanian: romanian 
josh: josh 
traduceri: traduceri 
even: even 
national: national 
bein: bein 
aise: aise 
point: point 
pageant: pageant 
c: c 
school: school 
crime: crime 
doveman: doveman 
credit: credits 
scholar: scholars 
place: place 
guess: guess 
makin: makin 
ooh: ooh 
umaczenie: umaczenie 
still: still 
traduction: traduction 
type: type 
chart: charts 
marjorie: marjorie 
woo: woo 
source: source 
translation: translation translations 
referred: referred 
learn: learn 
lark: lark 
album: album 
dream: dreams 
ivy: ivy 
percussion: percussion 
traduzione: traduzione 
mom: mom 
keyboard: keyboards 
sell: sell 
deutsche: deutsche 
low: low 
etc: etc 
embed: embed 
betty: betty 
recording: recording 
rk: rk 
featured: featured 
nothin: nothin 
americana: americana 
guideline: guidelines 
rom: rom 
first: first 
studio: studio 
skippin: skippin 
track: track 
country: country 
tell: tell 
b: b 
rush: rush 
w: w 
damn: damn 
makeup: makeup 
biggest: biggest 
knowledge: knowledge 
bates: bates 
bold: bold 
kaufman: kaufman 
twin: twin 
cancel: cancel 
verified: verified 
pre: pre 
sellin: sellin 
advertise: advertise 
part: parts part 
eye: eyes 
benjamin: benjamin 
calbi: calbi 
portugu: portugu 
ah: ah 
town: town 
stop: stop 
bersetzungen: bersetzungen 
traducere: traducere 
f: f 
transcription: transcription 
e: es e 
come: come 
never: never 
holiday: holidays 
traductions: traductions 
produced: produced 
hollywood: hollywood 
promote: promote 
bleacher: bleachers 
met: met 
soul: soul 
closure: closure 
ultimate: ultimate 
misery: misery 
al: al 
ballad: ballad 
song: songs song 
give: give 
side: side 
broken: broken 
fallone: fallone 
august: august 
tag: tags 
always: always 
eighth: eighth 
polskie: polskie 
since: since 
header: headers 
portuguese: portuguese 
press: press 
bass: bass 
holding: holdings 
storyline: storyline 
italiane: italiane 
contemporary: contemporary 
read: read 
small: small 
privacy: privacy 
insight: insight 
prom: prom 
z: z 
lanz: lanz 
like: like 
job: jobs 
italian: italian 
island: island 
character: character 
answer: answer 
alternative: alternative 
go: go 
turkish: turkish 
question: question 
line: lines 
steve: steve 
titular: titular 
visit: visit 
synthesizer: synthesizer 
uh: uh 
individual: individual 
espa: espa 
contact: contact 
comment: comments comment 
llc: llc 
ukrainian: ukrainian 
date: date 
shop: shop 
continuation: continuation 
left: left 
tradu: tradu 
format: format 
soft: soft 
old: old 
aaron: aaron 
drop: drop 
music: music 
add: add 
eviri: eviri 
ml: ml 
pop: pop 
sisk: sisk 
v: v 
mastering: mastering 
gold: gold 
james: james 
different: different 
ti: tis 
champagne: champagne 
star: stars 
deutsch: deutsch 
seems: seems 
well: well 
u: us u 
songwriter: songwriter 
happiness: happiness 
chorus: chorus 
information: information 
expand: expand 
forum: forum 
cupid: cupid 
clarified: clarified 
copyright: copyright 
sample: samples 
personnel: personnel 
piss: piss 
ol: ol 
traduzioni: traduzioni 
fran: fran 
h: h 
body: body 
written: written 
german: german 
policy: policy 
tambourine: tambourine 
n: n 
younger: younger 
folk: folk 
release: release 
ever: ever 
shiny: shiny 
brighter: brighter 
l: l 
evermore: evermore 
sok: sok 
home: home 
tolerate: tolerate 
sign: sign 
calmer: calmer 
story: story 
return: return 
girl: girl 
artist: artists 
season: season 
collection: collection 
p: p 
back: back 
direct: direct 
narrative: narrative 
traducci: traducci 
honey: honey 
inez: inez 
way: way 
american: american 
umaczenia: umaczenia 
post: post 
verse: verse 
taylor: taylor 
licensing: licensing 
share: share 
transcriber: transcribers 
distributor: distributor 
wish: wishes 
willow: willow 
ya: ya 
shined: shined 
ong: ong 
problem: problems 
distinguish: distinguish 
view: view 
scheme: schemes 
french: french 
x: x 
drum: drums 
repeating: repeating 
guide: guide 
annotation: annotation 
italiana: italiana 
dorothea: dorothea 
show: show 
term: terms 
dorathea: dorathea 
friend: friends 
late: late 
hometown: hometown 
lyric: lyric lyrics 
queen: queen 
version: version 
adult: adult 
got: got 
check: check 
piano: piano 
fact: facts 
personal: personal 
italic: italics 
greg: greg 
laura: laura 
singer: singer 
went: went 
mixing: mixing 
j: j 
italiano: italiano 
use: use 
spanish: spanish 
tupelo: tupelo 
section: section 
prevod: prevod 
told: told 
video: videos 
developer: developers 
tired: tired 
love: love 
hot: hot 
mind: mind 
screen: screen 
outro: outro 
ford: ford 
park: park 
engineer: engineer 
also: also 
chase: chase 
rock: rock 
em: em 
short: short 
ask: ask 
peach: peaches 
teddy: teddy 
tiny: tiny 
musical: musical 
traducciones: traducciones 
jonathan: jonathan 
prevodi: prevodi 
known: known 
k: k 
polski: polski 
anything: anything 
