q: q 
think: think 
perform: perform 
spoke: spoke 
created: created 
world: world 
guitar: guitar 
manic: manic 
spotify: spotify 
know: know 
rescue: rescue 
alanis: alanis 
search: search 
baby: baby 
hey: hey 
fucking: fucking 
kidz: kidz 
ai: aises ais 
meant: meant 
emi: emi 
final: final 
g: g 
december: december 
interpolation: interpolations 
vocalist: vocalists 
wanna: wanna 
certification: certifications 
might: might 
riaa: riaa 
r: r 
third: third 
fill: fill 
contributor: contributor contributors 
dansk: dansk 
far: far 
publishing: publishing 
jamee: jamee 
fan: fans 
write: write 
genius: genius 
billboard: billboard 
understand: understand 
infidelity: infidelity 
see: see 
tear: tears 
target: target 
even: even 
ryan: ryan 
girl: girls 
universal: universal 
aise: aise 
c: c 
instead: instead 
start: start 
credit: credits 
ashley: ashley 
similarity: similarities 
scholar: scholars 
jeremy: jeremy 
record: records 
made: made 
still: still 
burg: burg 
traduction: traduction 
live: live 
type: type 
chart: charts 
multiple: multiple 
english: english 
garrett: garrett 
translation: translation translations 
reyes: reyes 
source: source 
learn: learn 
process: process 
learning: learning 
album: album 
ttelse: ttelse 
sell: sell 
oh: oh 
one: one 
assistant: assistant 
etc: etc 
hindi: hindi 
embed: embed 
recording: recording 
bout: bout 
rk: rk 
featured: featured 
beautiful: beautiful 
ti: ti 
guideline: guidelines 
gotta: gotta 
first: first 
studio: studio 
appeared: appeared 
track: track 
country: country 
tell: tell 
b: b 
nobody: nobody 
w: w 
forever: forever 
biggest: biggest 
knowledge: knowledge 
would: would 
pasco: pasco 
bold: bold 
twin: twin 
something: something 
cancel: cancel 
verified: verified 
pre: pre 
following: following 
admin: admin 
kurstin: kurstin 
advertise: advertise 
vision: vision 
warning: warning 
prior: prior 
part: parts part 
bit: bit 
aidan: aidan 
ranta: ranta 
producer: producer 
saying: saying 
gehringer: gehringer 
sorry: sorry 
jab: jabs 
f: f 
transcription: transcription 
cullen: cullen 
never: never 
little: little 
traductions: traductions 
produced: produced 
hilliker: hilliker 
sahyoun: sahyoun 
promote: promote 
exclusive: exclusive 
hate: hate 
vuernick: vuernick 
jot: jot 
frustration: frustrations 
ultimate: ultimate 
tried: tried 
al: al 
ballad: ballad 
song: songs song 
broken: broken 
tag: tags 
bmi: bmi 
always: always 
car: cars 
lap: lap 
haha: haha 
alex: alex 
relationship: relationship 
jichu: jichu 
commissioner: commissioner 
targa: targa 
header: headers 
whilst: whilst 
portuguese: portuguese 
press: press 
bass: bass 
holding: holdings 
week: week 
electric: electric 
mike: mike 
thing: things 
tilley: tilley 
read: read 
privacy: privacy 
asked: asked 
without: without 
money: money 
insight: insight 
z: z 
like: like 
job: jobs 
phonographic: phonographic 
colin: colin 
character: character 
answer: answer 
explaining: explaining 
finally: finally 
turkish: turkish 
enough: enough 
touch: touch 
question: question 
line: lines 
hole: hole 
visit: visit 
gonna: gonna 
half: half 
throwing: throwing 
individual: individual 
espa: espa 
contact: contact 
comment: comments comment 
behind: behind 
llc: llc 
date: date 
erban: erban 
shop: shop 
ex: ex 
eazy: eazy 
bridge: bridge 
format: format 
mago: mago 
steel: steel 
said: said 
drop: drop 
farsi: farsi 
music: music 
remix: remix 
boyfriend: boyfriend 
add: add 
concept: concept 
eviri: eviri 
ml: ml 
regret: regret 
pop: pop 
killing: killing 
april: april 
acoustic: acoustic 
v: v 
e: e 
stranger: stranger 
get: get 
mastering: mastering 
john: john 
different: different 
alligator: alligator 
original: original 
label: label 
cause: cause 
japanese: japanese 
well: well 
u: us u 
november: november 
channel: channel 
chorus: chorus 
ghenea: ghenea 
ran: ran 
hand: hands 
information: information 
expand: expand 
right: right rights 
voicenote: voicenote 
publisher: publisher 
halsey: halsey 
forum: forum 
cupid: cupid 
unless: unless 
copyright: copyright 
sample: samples 
personnel: personnel 
inspired: inspired 
take: take 
yeah: yeah 
long: long 
ol: ol 
fran: fran 
graveyard: graveyard 
h: h 
preceded: preceded 
breaking: breaking 
written: written 
german: german 
subtle: subtle 
policy: policy 
mcknight: mcknight 
n: n 
video: video videos 
dominic: dominic 
release: release 
ever: ever 
l: l 
yes: yes 
ed: ed 
share: shares share 
sign: sign 
drug: drugs 
idol: idols 
bop: bop 
artist: artists 
over: overs 
reference: references 
interlude: interlude 
collection: collection 
p: p 
clementine: clementine 
back: back 
traducci: traducci 
way: way 
hinted: hinted 
verse: verse 
fourth: fourth 
licensing: licensing 
transcriber: transcribers 
previous: previous 
language: languages 
distinguish: distinguish 
hanes: hanes 
kid: kids 
director: director 
cover: covers cover 
view: view 
french: french 
sad: sad 
x: x 
pours: pours 
del: del 
drum: drums 
repeating: repeating 
guide: guide 
inside: inside 
cheat: cheats 
suspected: suspected 
else: else 
annotation: annotation 
julian: julian 
term: terms 
black: black 
lyric: lyric lyrics 
version: version 
capitol: capitol 
got: got 
check: check 
really: really 
fact: facts 
personal: personal 
say: say 
promotional: promotional 
italic: italics 
greg: greg 
man: man 
mixing: mixing 
chest: chest 
j: j 
single: singles single 
danish: danish 
photography: photography 
use: use 
spanish: spanish 
section: section 
ey: ey 
ascap: ascap 
youtube: youtube 
performance: performance 
anger: anger 
group: group 
time: time 
boy: boys 
gifted: gifted 
interpolate: interpolate 
malice: malice 
developer: developers 
love: love 
aria: aria 
feel: feel 
official: official 
hot: hot 
nothing: nothing 
mad: mad 
outro: outro 
put: put 
help: help 
engineer: engineer 
installment: installment 
suga: suga 
everybody: everybody 
also: also 
influenced: influenced 
responded: responded 
vecchio: vecchio 
ask: ask 
peach: peaches 
glad: glad 
musical: musical 
january: january 
remixes: remixes 
october: october 
traducciones: traducciones 
chris: chris 
k: k 
tweet: tweet 
design: design 
sto: sto 
