q: q 
number: number 
created: created 
world: world 
carter: carter 
liberto: liberto 
hit: hit 
exposition: exposition 
rescue: rescue 
hill: hills 
wrote: wrote 
search: search 
final: final 
g: g 
vocalist: vocalists 
family: family 
might: might 
goostavo: goostavo 
vivian: vivian 
r: r 
best: best 
bear: bear 
contributor: contributor contributors 
san: san 
digital: digital 
shade: shades 
genius: genius 
understand: understand 
lewis: lewis 
wild: wild 
even: even 
avi: avi 
morning: morning 
explosion: explosion 
sound: sound 
dedicated: dedicated 
ryan: ryan 
frank: frank 
c: c 
apology: apology 
credit: credits 
scholar: scholars 
second: second 
child: child 
guess: guess 
gray: gray 
record: records 
made: made 
still: still 
live: live 
type: type 
chart: charts 
fire: fire 
source: source 
bethesda: bethesda 
learn: learn 
express: express 
someone: someone 
overshadows: overshadows 
sell: sell 
oh: oh 
one: one 
etc: etc 
courage: courage 
embed: embed 
perkins: perkins 
mode: mode 
denver: denver 
sing: sing 
featured: featured 
obsessive: obsessive 
guideline: guidelines 
heart: heart hearts 
sonic: sonic 
shortly: shortly 
harris: harris 
first: first 
falling: falling 
track: track 
entertainment: entertainment 
jesus: jesus 
country: country 
flame: flames 
bonanza: bonanza 
dog: dog 
banned: banned 
b: b 
walk: walk 
w: w 
forever: forever 
biggest: biggest 
knowledge: knowledge 
hiltons: hiltons 
tennessee: tennessee 
would: would 
bold: bold 
game: game 
twin: twin 
cancel: cancel 
verified: verified 
train: train 
advertise: advertise 
vida: vida 
warning: warning 
perfect: perfect 
dadood: dadood 
part: parts part 
sold: sold 
road: roads 
cotton: cotton 
viva: viva 
f: f 
transcription: transcription 
ballroom: ballroom 
never: never 
free: free 
produced: produced 
promote: promote 
springsteen: springsteen 
heaven: heaven 
nic: nic 
fallout: fallout 
indroducing: indroducing 
ring: ring 
ultimate: ultimate 
spirit: spirit 
dancer: dancer 
night: night 
jerry: jerry 
song: songs song 
give: give 
broken: broken 
tag: tags 
early: early 
always: always 
tonight: tonight 
higher: higher 
dean: dean 
jones: jones 
medley: medley 
renard: renard 
became: became 
make: makes 
header: headers 
press: press 
holding: holdings 
kaplan: kaplan 
originally: originally 
except: except 
another: another 
peace: peace 
read: read 
privacy: privacy 
insight: insight 
z: z 
fiery: fiery 
like: like 
job: jobs 
statler: statler 
ethiopian: ethiopians 
answer: answer 
alternative: alternative 
finally: finally 
performance: performances performance 
band: band 
question: question 
danielle: danielle 
burning: burning 
line: lines line 
merle: merle 
visit: visit 
lee: lee 
thing: thing 
individual: individual 
contact: contact 
personality: personality 
comment: comments comment 
llc: llc 
instrumental: instrumental 
date: date 
week: weeks 
shop: shop 
imase: imase 
connor: connor 
closing: closing 
format: format 
certified: certified 
valley: valley 
march: march 
said: said 
drop: drop 
music: music 
winter: winter 
add: add 
battle: battle 
ml: ml 
death: death 
used: used 
april: april 
v: v 
e: e 
crucified: crucified 
rebel: rebel 
romanized: romanized 
gold: gold 
john: john 
different: different 
bruce: bruce 
soon: soon 
label: label 
break: break 
u: us u 
kilgore: kilgore 
failure: failures 
daisy: daisy 
chorus: chorus 
jam: jam 
information: information 
expand: expand 
remember: remember 
desire: desire 
anita: anita 
forum: forum 
cupid: cupid 
copyright: copyright 
sample: samples sample 
take: take 
acknowledges: acknowledges 
meet: meet 
da: da 
la: la 
care: care 
h: h 
green: green 
flat: flat 
written: written 
policy: policy 
downloads: downloads 
june: june 
brother: brothers 
n: n 
sang: sang 
release: release 
ever: ever 
l: l 
top: top 
home: home 
sister: sister 
sign: sign 
carl: carl 
month: months 
artist: artists 
yuma: yuma 
hurt: hurt 
ft: ft 
bookend: bookend 
career: career 
collection: collection 
dood: dood 
p: p 
adriansings: adriansings 
similar: similar 
emmylou: emmylou 
fell: fell 
american: american 
columbia: columbia 
verse: verse 
licensing: licensing 
share: share 
contract: contract 
married: married 
transcriber: transcribers 
journal: journals 
sixty: sixties 
eye: eye 
distinguish: distinguish 
wife: wife 
kid: kids 
johnny: johnny 
seven: seven 
nuclear: nuclear 
cover: covers cover 
million: million 
view: view 
sad: sad 
came: came 
x: x 
repeating: repeating 
guide: guide 
annotation: annotation 
alamo: alamo 
bound: bound 
big: big 
husband: husband 
copilot: copilot 
box: box 
term: terms 
black: black 
proud: proud 
lyric: lyric lyrics 
version: version 
party: party 
connect: connect 
god: god 
staying: staying 
taste: taste 
check: check 
thank: thank 
carousel: carousel 
fact: facts 
personal: personal 
italic: italics 
compulsive: compulsive 
man: man 
law: law 
went: went 
milkshake: milkshake 
virginia: virginia 
j: j 
dagame: dagames 
use: use 
experience: experience 
section: section 
extremely: extremely 
miss: miss 
commercially: commercially 
video: videos 
friend: friend 
interpolate: interpolate 
developer: developers 
angel: angel 
inspiration: inspiration 
love: love 
conference: conference 
burn: burns 
hot: hot 
mad: mad 
outro: outro 
preparation: preparation 
lord: lord 
skaville: skaville 
also: also 
short: short 
ask: ask 
recorded: recorded 
sweet: sweet 
alive: alive 
continue: continue 
january: january 
musical: musical 
cash: cash 
quentin: quentin 
somewhere: somewhere 
forty: forty 
k: k 
