sleeve: sleeve 
q: q 
think: think 
kyoto: kyoto 
thought: thoughts 
around: around 
saltine: saltines 
created: created 
together: together 
world: world 
guitar: guitar 
know: know knows 
predictably: predictably 
begin: begins 
rescue: rescue 
wrote: wrote 
search: search 
brasil: brasil 
fiddle: fiddle 
graceland: graceland 
crazy: crazy 
could: could 
icu: icu 
hey: hey 
title: title 
fucking: fucking 
ai: aises ais 
g: g 
nashville: nashville 
vocalist: vocalists 
wanna: wanna 
might: might 
r: r 
happens: happens 
contributor: contributor 
ca: ca 
ocean: oceans 
someday: someday 
satellite: satellite 
buy: buy 
write: write 
genius: genius 
understand: understand 
ninety: ninety 
people: people 
end: end 
even: even 
chinese: chinese 
floor: floor 
sound: sound 
aise: aise 
text: text 
c: c 
belief: belief 
garden: garden 
moon: moon 
credit: credits 
rest: rest 
scholar: scholars 
wish: wish 
ooh: ooh 
almost: almost 
slowcore: slowcore 
umaczenie: umaczenie 
made: made 
traduction: traduction 
felt: felt 
hall: hall 
apple: apple 
type: type 
chart: charts 
intrude: intrude 
source: source 
control: control 
turn: turns 
located: located 
learn: learn 
mdma: mdma 
gone: gone 
album: album 
gut: gut 
savior: savior 
yelled: yelled 
steinberg: steinberg 
traduzione: traduzione 
hang: hang 
someone: someone 
mom: mom 
sell: sell 
shit: shit 
landed: landed 
self: self 
nme: nme 
etc: etc 
embed: embed 
recording: recording 
bowed: bowed 
strung: strung 
sing: sing 
featured: featured 
rk: rk 
good: good 
guideline: guidelines 
remotely: remotely 
first: first 
studio: studio studios 
closest: closest 
canadian: canadian 
track: track 
caring: caring 
theatre: theatre 
country: country 
couple: couple 
phoebe: phoebe 
gruska: gruska 
cheek: cheeks 
hate: hates 
b: b 
flavoured: flavoured 
rush: rush 
nobody: nobody 
regarding: regarding 
w: w 
south: south 
biggest: biggest 
knowledge: knowledge 
would: would 
christian: christian 
excuse: excuse 
bold: bold 
organ: organ 
twin: twin 
something: something 
harrison: harrison 
cancel: cancel 
verified: verified 
following: following 
going: going 
advertise: advertise 
part: parts part 
bridgers: bridgers 
direction: direction 
hope: hope 
finishing: finishing 
reuniting: reuniting 
hutson: hutson 
portugu: portugu 
town: town 
pick: picks 
f: f 
transcription: transcription 
e: es e 
tourist: tourist 
asking: asking 
come: come 
punisher: punisher 
city: city 
traductions: traductions 
produced: produced 
awesome: awesome 
promote: promote 
interview: interview 
ultimate: ultimate 
al: al 
shrine: shrine 
ballad: ballad 
wind: winds 
agreed: agreed 
song: songs song 
broken: broken 
tag: tags 
via: via 
always: always 
pump: pump 
polskie: polskie 
tony: tony 
lucy: lucy 
believed: believed 
happy: happy 
header: headers 
suicidal: suicidal 
sebastian: sebastian 
complex: complex 
spring: springs 
press: press 
bass: bass 
holding: holdings 
italiane: italiane 
jun: jun 
thing: things thing 
shoe: shoes 
th: th 
read: read 
trip: trip 
privacy: privacy 
without: without 
insight: insight 
mile: miles 
z: z 
halloween: halloween 
like: like 
job: jobs 
every: every 
answer: answer 
bandmates: bandmates 
alternative: alternative 
go: go 
nuys: nuys 
excited: excited 
reflecting: reflecting 
decision: decisions 
question: question 
stereogum: stereogum 
line: lines 
van: van 
whatever: whatever 
stuff: stuff 
high: high 
visit: visit 
gonna: gonna 
baker: baker 
make: make 
lee: lee 
individual: individual 
espa: espa 
contact: contact 
comment: comments comment 
llc: llc 
date: date 
shop: shop 
kobalt: kobalt 
finished: finished 
memphis: memphis 
williams: williams 
bridge: bridge 
left: left 
therapy: therapy 
turned: turned 
tradu: tradu 
format: format 
presley: presley 
magical: magical 
said: said 
drop: drop 
julien: julien 
music: music 
extent: extent 
thinking: thinking 
add: add 
eviri: eviri 
ml: ml 
loud: loud 
pop: pop 
acoustic: acoustic 
v: v 
ate: ate 
get: get 
rebel: rebel 
meditation: meditation 
longer: longer 
true: true 
coming: coming 
different: different 
original: original 
berg: berg 
reflection: reflection 
label: label 
vocal: vocals 
u: us u 
well: well 
rehab: rehab 
knew: knew 
songwriter: songwriter 
meaning: meaning 
chorus: chorus 
ran: ran 
information: information 
expand: expand 
serotonin: serotonin 
right: right rights 
wonder: wonders 
publisher: publisher 
want: want wants 
dead: dead 
forum: forum 
cupid: cupid 
moment: moment 
copyright: copyright 
sample: samples 
laced: laced 
yeah: yeah 
ol: ol 
meet: meet 
traduzioni: traduzioni 
fran: fran 
h: h 
kind: kind 
somebody: somebody 
everyone: everyone 
written: written 
led: led 
hard: hard 
policy: policy 
june: june 
n: n 
dacus: dacus 
holly: holly 
folk: folk 
release: release 
writing: writing 
l: l 
home: home 
attraction: attraction 
sign: sign 
answered: answered 
tough: tough 
human: human 
kid: kid 
ticket: ticket 
artist: artists 
others: others 
collection: collection 
p: p 
clue: clue 
traducci: traducci 
american: american 
umaczenia: umaczenia 
post: post 
verse: verse 
keep: keep 
licensing: licensing 
share: share 
transcriber: transcribers 
hardest: hardest 
refers: refers 
danger: danger 
distributor: distributor 
dvd: dvd 
guy: guys 
quickly: quickly 
trying: trying 
outside: outside 
sara: sara 
distinguish: distinguish 
homage: homage 
listening: listening 
boygenius: boygenius 
cover: covers 
happen: happen 
view: view 
came: came 
x: x 
secretly: secretly 
repeating: repeating 
guide: guide 
record: record 
commentary: commentary 
annotation: annotation 
life: lives life 
italiana: italiana 
realised: realised 
harmony: harmony 
term: terms 
friend: friends 
lyric: lyric lyrics 
version: version 
menu: menu 
check: check 
really: really 
translation: translations 
lived: lived 
ethan: ethan 
fact: facts 
personal: personal 
spent: spent 
italic: italics 
singer: singer 
watkins: watkins 
j: j 
italiano: italiano 
use: use 
section: section 
ascap: ascap 
performance: performance 
trilemma: trilemma 
time: time 
elvis: elvis 
video: videos 
developer: developers 
love: love 
person: person 
actual: actual 
hayley: hayley 
struggled: struggled 
hot: hot 
mind: mind 
jumping: jumping 
outro: outro 
help: help 
laughing: laughing 
took: took 
stare: stare 
mississippi: mississippi 
also: also 
super: super 
tempting: tempting 
em: em 
walked: walked 
find: finds 
ask: ask 
recorded: recorded 
peach: peaches 
whitford: whitford 
chew: chew 
musical: musical 
yo: yo 
destructive: destructive 
addiction: addiction 
traducciones: traducciones 
started: started 
banjo: banjo 
k: k 
polski: polski 
anything: anything 
