q: q 
perform: perform 
around: around 
change: change 
fine: fine 
created: created 
together: together 
world: world 
guitar: guitar 
know: know knows 
rediscover: rediscover 
brasil: brasil 
baby: baby 
lover: lover 
hey: hey 
smiled: smiled 
ai: aises ais 
meant: meant 
g: g 
bersetzung: bersetzung 
vocalist: vocalists 
christopher: christopher 
leaked: leaked 
might: might 
r: r 
best: best 
pocket: pocket pockets 
srpski: srpski 
folklore: folklore 
contributor: contributor contributors 
magyar: magyar 
dessner: dessner 
graffiti: graffiti 
lied: lied 
lost: lost 
billboard: billboard 
genius: genius 
understand: understand 
swift: swift 
see: see 
tear: tears 
josh: josh 
people: people 
even: even 
belong: belong 
universal: universal 
aise: aise 
c: c 
credit: credits 
melted: melted 
scholar: scholars 
child: child 
wish: wish 
record: records record 
marenmorris: marenmorris 
umaczenie: umaczenie 
connected: connected 
still: still 
scooter: scooter 
burg: burg 
traduction: traduction 
honor: honor 
type: type 
maren: maren 
chart: charts 
english: english 
white: white 
translation: translation translations 
source: source 
last: last 
learn: learn 
jump: jump 
album: album 
percussion: percussion 
keyboard: keyboards 
sell: sell 
tire: tires 
scratch: scratch 
midnight: midnight 
one: one 
underneath: underneath 
deutsche: deutsche 
low: low 
carusoe: carusoe 
etc: etc 
traded: traded 
embed: embed 
recording: recording 
rk: rk 
featured: featured 
guideline: guidelines 
harmonica: harmonica 
randy: randy 
first: first 
studio: studio 
track: track 
background: background 
country: country 
tell: tell 
county: county 
b: b 
w: w 
forever: forever 
much: much 
die: die 
biggest: biggest 
knowledge: knowledge 
taylorswift: taylorswift 
wasted: wasted 
bold: bold 
addition: addition 
eric: eric 
kaufman: kaufman 
twin: twin 
cancel: cancel 
describes: describes 
verified: verified 
kurstin: kurstin 
pleasure: pleasure 
advertise: advertise 
vida: vida 
part: parts part 
stall: stalls 
hope: hope 
blasko: blasko 
road: roads 
mr: mr 
viva: viva 
sorry: sorry 
portugu: portugu 
fifteen: fifteen 
bersetzungen: bersetzungen 
making: making 
f: f 
transcription: transcription 
e: es e 
feeling: feeling 
programmer: programmer 
rain: rain 
enjoyed: enjoyed 
never: never 
come: come 
traductions: traductions 
produced: produced 
grin: grin 
enjoy: enjoy 
learned: learned 
day: day 
agust: agust 
promote: promote 
door: door 
lyrically: lyrically 
leave: leave 
incredible: incredible 
met: met 
ultimate: ultimate 
al: al 
song: songs song 
side: side 
broken: broken 
tag: tags 
via: via 
always: always 
tonight: tonight 
polskie: polskie 
contains: contains 
bye: bye 
pavement: pavement 
happy: happy 
header: headers 
able: able 
portuguese: portuguese 
press: press 
bass: bass 
holding: holdings 
week: week 
electric: electric 
amount: amount 
read: read 
privacy: privacy 
reminds: reminds 
superstar: superstar 
insight: insight 
z: z 
like: like 
job: jobs 
phonographic: phonographic 
eastern: eastern 
every: every 
answer: answer 
turkish: turkish 
question: question 
rowe: rowe 
line: lines 
unreleased: unreleased 
visit: visit 
stain: stain 
synthesizer: synthesizer 
freedom: freedom 
debuted: debuted 
individual: individual 
espa: espa 
contact: contact 
bella: bella 
comment: comments comment 
llc: llc 
instrumental: instrumental 
date: date 
shop: shop 
muddy: muddy 
tradu: tradu 
format: format 
fearless: fearless 
old: old 
aaron: aaron 
march: march 
said: said 
drop: drop 
vault: vault 
music: music 
remix: remix 
add: add 
bathroom: bathroom 
breathe: breathe 
eviri: eviri 
ml: ml 
pop: pop 
found: found 
used: used 
april: april 
acoustic: acoustic 
v: v 
get: gets get 
instagram: instagram 
mastering: mastering 
find: find 
different: different 
deutsch: deutsch 
work: work 
label: label 
vocal: vocals vocal 
break: break 
cause: cause 
well: well 
u: us u 
air: air 
songwriter: songwriter 
dried: dried 
chorus: chorus 
hand: hands 
information: information 
expand: expand 
republic: republic 
right: right 
forum: forum 
cupid: cupid 
serbian: serbian 
copyright: copyright 
sample: samples 
helping: helping 
personnel: personnel 
long: long 
ol: ol 
worst: worst 
la: la 
fran: fran 
h: h 
written: written 
german: german 
policy: policy 
june: june 
n: n 
reinterpret: reinterpret 
release: release 
l: l 
evermore: evermore 
sok: sok 
sign: sign 
element: elements 
project: project 
past: past 
story: story 
fall: fall 
today: today 
ending: ending 
burned: burned 
artist: artists 
ft: ft 
collection: collection 
p: p 
similar: similar 
held: held 
mark: marks 
traducci: traducci 
untouchable: untouchable 
feature: features 
way: way 
umaczenia: umaczenia 
verse: verse 
taylor: taylor 
licensing: licensing 
share: share 
transcriber: transcribers 
turn: turn 
fairytale: fairytale 
thematic: thematic 
distinguish: distinguish 
recently: recently 
listening: listening 
cried: cried 
view: view 
french: french 
stone: stones 
slick: slick 
x: x 
drum: drums drum 
repeating: repeating 
guide: guide 
commentary: commentary 
horse: horse 
annotation: annotation 
julian: julian 
sophomore: sophomore 
term: terms 
lyric: lyric lyrics 
version: version 
featuring: featuring 
god: god 
got: got 
check: check 
really: really 
lived: lived 
piano: piano 
fact: facts 
personal: personal 
spent: spent 
italic: italics 
stephen: stephen 
greg: greg 
singer: singer 
mixing: mixing 
j: j 
use: use 
spanish: spanish 
loved: loved 
section: section 
dollar: dollar 
single: single 
watched: watched 
wall: walls 
worked: worked 
group: group 
prevod: prevod 
time: time 
merrill: merrill 
video: videos 
developer: developers 
love: love 
hot: hot 
outro: outro 
ford: ford 
engineer: engineer 
released: released 
also: also 
em: em 
perfectly: perfectly 
elvira: elvira 
clean: clean 
ask: ask 
swore: swore 
musical: musical 
breath: breath 
traducciones: traducciones 
jonathan: jonathan 
prevodi: prevodi 
k: k 
collaborate: collaborate 
morris: morris 
releasing: releasing 
polski: polski 
former: former 
