q: q 
think: think 
perform: perform 
around: around 
change: change 
fine: fine 
created: created 
world: world 
guitar: guitar guitars 
know: know 
rescue: rescue 
wrote: wrote 
search: search 
brasil: brasil 
baby: baby 
hey: hey 
ai: aises ais 
g: g 
bersetzung: bersetzung 
party: parties 
away: away 
vocalist: vocalists 
christopher: christopher 
might: might 
r: r 
pedal: pedal 
best: best 
allegedly: allegedly 
srpski: srpski 
contributor: contributor contributors 
showed: showed 
magyar: magyar 
someday: someday 
far: far 
mine: mine 
cruel: cruel 
svensk: svensk 
sophie: sophie 
billboard: billboard 
genius: genius 
understand: understand 
swift: swift 
see: see 
svenska: svenska 
new: new 
josh: josh 
end: end 
even: even 
belong: belong 
sound: sound 
universal: universal 
aise: aise 
c: c 
looked: looked 
apology: apology 
era: era 
credit: credits 
rest: rest 
scholar: scholars 
place: place 
guess: guess 
swedish: swedish 
record: records 
name: name 
seat: seat 
listened: listened 
umaczenie: umaczenie 
traduction: traduction 
type: type 
apart: apart 
chart: charts chart 
white: white 
na: na 
translation: translation translations 
joe: joe 
reyes: reyes 
source: source 
last: last 
learn: learn 
jump: jump 
jon: jon 
vers: vers 
waitin: waitin 
album: album 
percussion: percussion 
cause: causes cause 
keyboard: keyboards 
sell: sell 
oh: oh 
underneath: underneath 
deutsche: deutsche 
upbeat: upbeat 
isa: isa 
assistant: assistant 
etc: etc 
embed: embed 
subject: subject 
recording: recording 
player: player 
rk: rk 
featured: featured 
hrvatski: hrvatski 
heartbreak: heartbreak 
good: good 
guideline: guidelines 
heart: heart 
sher: sher 
randy: randy 
wonderfully: wonderfully 
studio: studio 
track: track 
okay: okay 
background: background 
country: country 
peaked: peaked 
tell: tell 
proving: proving 
staple: staples 
b: b 
teen: teen 
hallmark: hallmarks 
string: string 
w: w 
brand: brand 
forever: forever 
heard: heard 
michael: michael 
biggest: biggest 
knowledge: knowledge 
would: would 
day: days day 
bold: bold 
shame: shame 
twin: twin 
look: look 
cancel: cancel 
sense: sense 
turner: turner 
verified: verified 
pre: pre 
sashay: sashay 
advertise: advertise 
pickin: pickin 
perfect: perfect 
part: parts part 
hope: hope 
room: room 
analogue: analogue 
definitely: definitely 
eye: eyes eye 
mr: mr 
sorry: sorry 
portugu: portugu 
smug: smug 
fifteen: fifteen 
bersetzungen: bersetzungen 
leaf: leaves 
f: f 
transcription: transcription 
e: es e 
feeling: feeling 
programmer: programmer 
rain: rain 
performer: performer 
come: come 
never: never 
traductions: traductions 
produced: produced 
promote: promote 
thought: thought 
door: door 
jack: jack 
angst: angst 
saxophone: saxophone 
sensibility: sensibility 
two: two 
alright: alright 
ultimate: ultimate 
misery: misery 
suit: suit 
ttning: ttning 
al: al 
artist: artist artists 
song: songs song 
side: side 
broken: broken 
tag: tags 
bmi: bmi 
early: early 
cusp: cusp 
creeping: creeping 
via: via 
always: always 
win: wins 
polskie: polskie 
since: since 
bye: bye 
melody: melodies 
matter: matter 
pain: pain 
make: makes 
header: headers 
happy: happy 
guy: guy 
portuguese: portuguese 
press: press 
bass: bass 
holding: holdings 
week: week 
electric: electric 
discus: discusses 
th: th 
read: read 
privacy: privacy 
superstar: superstar 
insight: insight 
z: z 
like: like 
job: jobs 
phonographic: phonographic 
every: every 
answer: answer 
go: go goes 
wonderful: wonderful 
turkish: turkish 
question: question 
rabenold: rabenold 
accompanied: accompanied 
rowe: rowe 
line: lines 
casually: casually 
visit: visit 
gonna: gonna 
synthesizer: synthesizer 
debuted: debuted 
regardless: regardless 
alone: alone 
individual: individual 
espa: espa 
contact: contact 
comment: comments comment 
llc: llc 
date: date 
erban: erban 
shop: shop 
indicator: indicator 
ex: ex 
bridge: bridge 
tradu: tradu 
format: format 
fearless: fearless 
steel: steel 
said: said 
drop: drop 
vault: vault 
music: music 
promise: promises 
admiration: admiration 
remix: remix 
add: add 
breathe: breathe 
eviri: eviri 
ml: ml 
pop: pop 
riddleberger: riddleberger 
sisk: sisk 
april: april 
acoustic: acoustic 
v: v 
next: next 
get: get 
mastering: mastering 
john: john 
different: different 
deutsch: deutsch 
scathing: scathing 
label: label 
vocal: vocals vocal 
well: well 
u: us u 
songwriter: songwriter 
amazon: amazon 
associated: associated 
chorus: chorus 
ghenea: ghenea 
evan: evan 
information: information 
expand: expand 
republic: republic 
right: right rights 
publisher: publisher 
take: takes 
face: face 
forum: forum 
cupid: cupid 
serbian: serbian 
antonoff: antonoff 
copyright: copyright 
sample: samples 
bored: bored 
personnel: personnel 
inspired: inspired 
round: round 
stay: stay 
ol: ol 
jonas: jonas 
smith: smith 
fran: fran 
h: h 
sort: sort 
written: written 
german: german 
subtle: subtle 
policy: policy 
annoyance: annoyance 
n: n 
release: release 
ever: ever 
l: l 
sok: sok 
sign: sign 
dignified: dignified 
past: past 
story: story 
girl: girl 
fall: fall 
today: today 
ending: ending 
surprise: surprise 
collection: collection 
breakin: breakin 
replied: replied 
p: p 
echo: echo 
traducci: traducci 
untouchable: untouchable 
way: way 
umaczenia: umaczenia 
verse: verse 
taylor: taylor 
licensing: licensing 
share: share 
transcriber: transcribers 
married: married 
turn: turn 
phased: phased 
fairytale: fairytale 
refers: refers 
distributor: distributor 
maria: maria 
dating: dating 
synths: synths 
inconvenience: inconvenience 
distinguish: distinguish 
hanes: hanes 
arm: arm 
deal: deals 
edt: edt 
cover: covers 
view: view 
everything: everything 
x: x 
hello: hello 
drum: drums 
repeating: repeating 
guide: guide 
horse: horse 
annotation: annotation 
insincere: insincere 
moved: moved 
term: terms 
late: late 
lyric: lyric lyrics 
version: version 
got: got 
check: check 
really: really 
hear: hear 
piano: piano 
fact: facts 
personal: personal 
promotional: promotional 
italic: italics 
stephen: stephen 
laura: laura 
singer: singer 
mixing: mixing 
full: full 
j: j 
cry: cry 
use: use 
spanish: spanish 
loved: loved 
section: section 
though: though 
miss: miss 
single: single 
pressed: pressed 
performance: performance 
group: group 
prevod: prevod 
told: told 
time: time 
maybe: maybe 
merrill: merrill 
video: videos 
developer: developers 
strategized: strategized 
love: love 
forgets: forgets 
rooney: rooney 
hot: hot 
sean: sean 
boy: boy 
revolves: revolves 
outro: outro 
goodbye: goodbye 
put: put 
ford: ford 
hutchinson: hutchinson 
life: life 
engineer: engineer 
run: run 
released: released 
also: also 
rock: rock 
em: em 
perfectly: perfectly 
elvira: elvira 
ask: ask 
peach: peaches 
towards: towards 
bad: bad 
musical: musical 
traducciones: traducciones 
prevodi: prevodi 
k: k 
polski: polski 
anything: anything 
