spivey: spivey 
q: q 
think: think 
number: number 
created: created 
world: world 
guitar: guitar 
know: know 
anna: anna 
lola: lola 
intro: intro 
operaci: operaci 
baby: baby 
handsome: handsome 
flavio: flavio 
fiddle: fiddle 
crazy: crazy 
could: could 
g: g 
nashville: nashville 
vocalist: vocalists 
wanna: wanna 
triunfo: triunfo 
might: might 
r: r 
third: third 
ndez: ndez 
pedal: pedal 
best: best 
contributor: contributor contributors 
feminism: feminism 
cast: cast 
watson: watson 
ally: ally 
billboard: billboard 
genius: genius 
understand: understand 
tear: tears 
wild: wild 
even: even 
girl: girls girl 
color: color 
c: c 
robert: robert 
dare: dare 
credit: credits 
scholar: scholars 
record: records 
jisoo: jisoo 
coachella: coachella 
noise: noise 
still: still 
live: live 
type: type 
byrom: byrom 
chart: charts 
shout: shout 
power: power 
raise: raise 
act: act 
source: source 
joe: joe 
learn: learn 
role: role 
politically: politically 
violeta: violeta 
pittaluga: pittaluga 
album: album 
shipley: shipley 
hang: hang 
addicted: addicted 
lady: ladies lady 
sell: sell 
oh: oh 
one: one 
assistant: assistant 
stand: stand 
glen: glen 
mercury: mercury 
etc: etc 
rob: rob 
embed: embed 
blue: blue 
sing: sing 
featured: featured 
beautiful: beautiful 
fern: fern 
four: four 
good: good 
guideline: guidelines 
heart: heart 
dylan: dylan 
paul: paul 
feelin: feelin 
studio: studio 
track: track tracks 
background: background 
woman: woman women 
action: action 
chemay: chemay 
peaked: peaked 
country: country 
b: b 
w: w 
much: much 
biggest: biggest 
knowledge: knowledge 
would: would 
monarch: monarch 
brent: brent 
need: need 
bold: bold 
huff: huff 
twin: twin 
cancel: cancel 
microphone: microphone 
leim: leim 
sense: sense 
verified: verified 
pre: pre 
going: going 
alaina: alaina 
advertise: advertise 
vida: vida 
harry: harry 
part: parts part 
anthem: anthems anthem 
lange: lange 
definitely: definitely 
eye: eyes 
viva: viva 
inhibition: inhibitions 
town: town 
f: f 
transcription: transcription 
stuart: stuart 
come: come comes 
never: never 
little: little 
free: free 
produced: produced 
haynie: haynie 
opening: opening 
promote: promote 
instrument: instruments 
franklin: franklin 
ninety: nineties 
leave: leave 
two: two 
alright: alright 
reversed: reversed 
spirit: spirit 
ultimate: ultimate 
night: night 
year: year 
imagined: imagined 
song: songs song 
broken: broken 
tag: tags 
larry: larry 
huh: huh 
via: via 
always: always 
tonight: tonight 
style: styles style 
header: headers 
press: press 
bass: bass 
holding: holdings 
lauren: lauren 
electric: electric 
mike: mike 
develop: develop 
sitar: sitar 
read: read 
jeff: jeff 
privacy: privacy 
insight: insight 
z: z 
like: like 
job: jobs 
every: every 
answer: answer 
palmer: palmer 
go: go 
mason: mason 
performance: performances 
meadow: meadows 
quality: quality 
question: question 
touch: touch 
line: lines line 
dann: dann 
whatever: whatever 
visit: visit 
gonna: gonna 
five: five 
synthesizer: synthesizer 
make: make 
audience: audience 
uh: uh 
thing: thing 
individual: individual 
contact: contact 
shirt: shirts 
comment: comments comment 
sanchez: sanchez 
llc: llc 
date: date 
week: weeks 
hypha: hypha 
shop: shop 
glenn: glenn 
format: format 
mark: mark 
popular: popular 
old: old 
steel: steel 
march: march 
men: men 
pretending: pretending 
said: said 
drop: drop 
bottom: bottom 
music: music 
remix: remix 
add: add 
impress: impress 
ml: ml 
correct: correct 
pop: pop 
lonely: lonely 
v: v 
e: e 
real: real 
get: gets get 
romanized: romanized 
mastering: mastering 
john: john 
different: different 
fun: fun 
label: label 
break: break 
vocal: vocals 
u: us u 
songwriter: songwriter 
ensamble: ensamble 
voice: voice 
chorus: chorus 
information: information 
murphy: murphy 
expand: expand 
laugh: laughs 
forum: forum 
anthemic: anthemic 
cupid: cupid 
entertain: entertain 
moment: moment 
copyright: copyright 
sample: samples sample 
bored: bored 
take: take 
yeah: yeah 
la: la 
vicevversa: vicevversa 
h: h 
beyond: beyond 
written: written 
policy: policy 
gay: gay 
duncan: duncan 
n: n 
video: video videos 
hobbs: hobbs 
save: save 
release: release 
ever: ever 
l: l 
home: home 
attraction: attraction 
sign: sign 
romance: romance 
holdin: holdin 
artist: artists 
ft: ft 
collection: collection 
p: p 
biff: biff 
chance: chance 
lot: lot 
honey: honey 
feature: features 
way: way 
canada: canada 
post: post 
shania: shania 
verse: verse 
licensing: licensing 
share: share 
transcriber: transcribers 
forget: forget 
prerogative: prerogative 
distinguish: distinguish 
hair: hair 
cover: covers 
view: view 
x: x 
balding: balding 
drum: drums 
repeating: repeating 
guide: guide 
annotation: annotation 
aubrey: aubrey 
term: terms 
black: black 
lyric: lyric lyrics 
version: version 
party: party 
totally: totally 
entertains: entertains 
check: check 
got: got 
really: really 
stupid: stupid 
fact: facts 
personal: personal 
hagen: hagen 
italic: italics 
singer: singer 
man: man 
play: play 
mixing: mixing 
j: j 
single: singles single 
skirt: skirts 
use: use 
section: section 
legacy: legacy 
time: time 
interpolate: interpolate 
developer: developers 
love: love 
friel: friel 
feel: feel 
hot: hot 
outro: outro 
brady: brady 
doin: doin 
life: life 
outta: outta 
engineer: engineer 
released: released 
everybody: everybody 
also: also 
rock: rock 
hajacos: hajacos 
short: short 
ask: ask 
flower: flower 
musical: musical 
remixes: remixes 
let: let 
dance: dance 
scream: scream 
twain: twain 
known: known 
slide: slide 
k: k 
condition: conditions 
