adam: adam 
q: q 
created: created 
world: world 
word: words 
rescue: rescue 
maid: maid 
til: til 
wing: wing 
search: search 
moriondo: moriondo 
war: war 
brown: browns brown 
sledge: sledge 
g: g 
vocalist: vocalists 
might: might 
grant: grant 
string: strings 
r: r 
shook: shook 
bear: bear 
hound: hound 
contributor: contributor contributors 
mouskouri: mouskouri 
mine: mine 
dear: dear 
cruel: cruel 
genius: genius 
understand: understand 
nelson: nelson 
bocelli: bocelli 
los: los 
end: end 
even: even 
belong: belong 
conniff: conniff 
frank: frank 
c: c 
begin: begin 
rough: rough 
whittaker: whittaker 
cold: cold 
garden: garden 
credit: credits 
scholar: scholars 
gregorian: gregorian 
george: george 
clayderman: clayderman 
fred: fred 
hosen: hosen 
record: records 
cliff: cliff 
made: made 
hall: hall 
nolesto: nolesto 
live: live 
type: type 
francis: francis 
linda: linda 
chart: charts 
nana: nana 
shout: shout 
english: english 
source: source 
barbra: barbra 
control: control 
sinatra: sinatra 
vera: vera 
learn: learn 
nogar: nogar 
cramer: cramer 
chloe: chloe 
william: william 
year: years 
thee: thee 
matson: matson 
brian: brian 
ch: ch 
dream: dreams 
sell: sell 
prozz: prozz 
etc: etc 
embed: embed 
nice: nice 
andrea: andrea 
jane: jane 
rogers: rogers 
peter: peter 
featured: featured 
heartbreak: heartbreak 
havran: havran 
te: tes 
edition: edition 
guideline: guidelines 
heart: heart 
angeles: angeles 
platter: platters 
first: first 
track: track 
rider: riders 
hotel: hotel 
country: country 
tell: tell 
dog: dog 
b: b 
floyd: floyd 
w: w 
ronstadt: ronstadt 
much: much 
die: die 
biggest: biggest 
knowledge: knowledge 
bennett: bennett 
manilow: manilow 
rodriguez: rodriguez 
bold: bold 
need: need 
melody: melody 
twin: twins twin 
mollin: mollin 
thorne: thorne 
cancel: cancel 
colorful: colorful 
verified: verified 
ronson: ronson 
mclean: mclean 
darling: darling 
blooded: blooded 
advertise: advertise 
titled: titled 
part: parts part 
frill: frills 
century: century 
civil: civil 
pato: pato 
along: along 
f: f 
transcription: transcription 
stuart: stuart 
gambatese: gambatese 
never: never 
produced: produced 
arteta: arteta 
tinder: tinder 
promote: promote 
aura: aura 
karel: karel 
pausini: pausini 
raleigh: raleigh 
mick: mick 
boyzone: boyzone 
ultimate: ultimate 
lifted: lifted 
ballad: ballad 
madison: madison 
song: songs song 
broken: broken 
engelbert: engelbert 
tag: tags 
bmi: bmi 
always: always 
richard: richard 
tony: tony 
xp: xp 
exceptionally: exceptionally 
jones: jones 
snow: snow 
demis: demis 
happy: happy 
header: headers 
retro: retro 
ernie: ernie 
press: press 
holding: holdings 
dirty: dirty 
originally: originally 
adriano: adriano 
th: th 
read: read 
privacy: privacy 
cop: cop 
california: california 
insight: insight 
movie: movies 
z: z 
katie: katie 
like: like 
wanda: wanda 
job: jobs 
go: go 
ken: ken 
performance: performances performance 
question: question 
fu: fu 
roussos: roussos 
line: lines 
steve: steve 
dolcemente: dolcemente 
studio: studios 
merle: merle 
visit: visit 
connie: connie 
enterprise: enterprises 
lee: lee 
individual: individual 
contact: contact 
ainhoa: ainhoa 
comment: comments comment 
humperdinck: humperdinck 
llc: llc 
instrumental: instrumental 
barry: barry 
date: date 
shop: shop 
kobalt: kobalt 
format: format 
presley: presley 
mark: mark 
drop: drop 
witchcraft: witchcraft 
music: music 
add: add 
chamberlain: chamberlain 
treat: treat 
ml: ml 
price: price 
acoustic: acoustic 
v: v 
e: e 
september: september 
nat: nat 
james: james 
true: true 
different: different 
caetano: caetano 
label: label 
amy: amy 
fulfilled: fulfilled 
u: us u 
rca: rca 
air: air 
pappalardo: pappalardo 
songwriter: songwriter 
voice: voice 
chorus: chorus 
jailhouse: jailhouse 
reno: reno 
levy: levy 
information: information 
expand: expand 
publisher: publisher 
want: want 
percy: percy 
forum: forum 
cupid: cupid 
toten: toten 
copyright: copyright 
sample: samples 
take: take 
authentic: authentic 
long: long 
ol: ol 
h: h 
lyrical: lyrical 
written: written 
victor: victor 
policy: policy 
brother: brothers 
n: n 
stereo: stereo 
square: square 
release: release 
l: l 
sign: sign 
raides: raides 
willie: willie 
project: project 
artist: artists 
marty: marty 
remembered: remembered 
ft: ft 
collection: collection 
p: p 
veloso: veloso 
way: way 
verse: verse 
licensing: licensing 
negative: negative 
share: share 
swallow: swallows 
transcriber: transcribers 
melua: melua 
fox: fox 
kenny: kenny 
jackson: jackson 
tender: tender 
robbins: robbins 
distinguish: distinguish 
hair: hair 
theme: theme 
roger: roger 
johnny: johnny 
shawn: shawn 
cover: covers cover 
view: view 
hallyday: hallyday 
right: rights 
came: came 
x: x 
repeating: repeating 
guide: guide 
annotation: annotation 
golden: golden 
hyland: hyland 
term: terms 
lyric: lyric lyrics 
version: version 
norah: norah 
macarons: macarons 
check: check 
daniel: daniel 
fact: facts 
personal: personal 
italic: italics 
lea: lea 
sunshine: sunshine 
hasselhoff: hasselhoff 
laura: laura 
ray: ray 
haggard: haggard 
singer: singer 
complete: complete 
heartache: heartaches 
david: david 
j: j 
oelhrich: oelhrich 
colvin: colvin 
use: use 
bastard: bastard 
section: section 
brand: brands 
group: group 
darby: darby 
time: time 
elvis: elvis 
video: videos 
interpolate: interpolate 
developer: developers 
gott: gott 
mina: mina 
love: love 
jasmin: jasmin 
hot: hot 
cole: cole 
vanished: vanished 
loving: loving 
life: life 
streisand: streisand 
nk: nk 
poulton: poulton 
also: also 
rock: rock 
ask: ask 
recorded: recorded 
peach: peaches 
sweet: sweet 
master: master 
teddy: teddy 
hollyridge: hollyridge 
musical: musical 
let: let 
known: known 
k: k 
king: king 
sutcliffe: sutcliffe 
donnell: donnell 
jenn: jenn 
