q: q 
think: think 
perform: perform 
created: created 
together: together 
world: world 
guitar: guitar 
jensen: jensen 
know: know 
rescue: rescue 
til: til 
wrote: wrote 
search: search 
resnick: resnick 
lover: lover 
ai: aises ais 
g: g 
bersetzung: bersetzung 
vocalist: vocalists 
christopher: christopher 
included: included 
might: might 
important: important 
r: r 
ny: ny 
dream: dream 
srpski: srpski 
contributor: contributor contributors 
ca: ca 
bet: bet 
someday: someday 
dessner: dessner 
journal: journal journals 
lost: lost 
billboard: billboard 
genius: genius 
wake: wake 
understand: understand 
swift: swift 
committee: committee 
docter: docter 
romanian: romanian 
new: new 
los: los 
josh: josh 
people: people 
growin: growin 
even: even 
polish: polish 
faking: faking 
sound: sound 
girl: girls girl 
aise: aise 
c: c 
begin: begin 
credit: credits 
seventeen: seventeen 
scholar: scholars 
getting: getting 
changing: changing 
record: records record 
almost: almost 
still: still 
traduction: traduction 
type: type 
chart: charts chart 
smile: smiles 
lose: lose 
violin: violin 
movin: movin 
translation: translation translations 
source: source 
last: last 
better: better 
sleep: sleep 
learn: learn 
numata: numata 
drink: drink 
yhung: yhung 
album: album 
ing: ing 
someone: someone 
keyboard: keyboards 
sell: sell 
oh: oh 
one: one ones 
deutsche: deutsche 
low: low 
etc: etc 
embed: embed 
matty: matty 
recording: recording 
strung: strung 
rk: rk 
featured: featured 
beautiful: beautiful 
nothin: nothin 
guideline: guidelines 
randy: randy 
angeles: angeles 
first: first 
studio: studio studios 
track: track 
fly: fly 
country: country 
tell: tell 
phoebe: phoebe 
cheek: cheeks 
b: b 
losing: losing 
joni: joni 
shoot: shoot 
w: w 
forever: forever 
much: much 
biggest: biggest 
knowledge: knowledge 
bold: bold 
twin: twin 
cancel: cancel 
become: become 
verified: verified 
pre: pre 
aging: aging 
advertise: advertise 
orchestrator: orchestrator 
part: parts part 
bridgers: bridgers 
everythin: everythin 
belfast: belfast 
room: room 
blasko: blasko 
cute: cute 
producer: producer 
eye: eyes 
maclellan: maclellan 
youth: youth 
ah: ah 
bersetzungen: bersetzungen 
f: f 
transcription: transcription 
come: come 
never: never 
hungarian: hungarian 
city: city 
traductions: traductions 
produced: produced 
vulnerable: vulnerable 
promote: promote 
woah: woah 
ango: ango 
hunt: hunt 
attention: attention 
bryce: bryce 
two: two 
radiance: radiance 
lucky: lucky 
ultimate: ultimate 
night: night 
al: al 
ballad: ballad 
song: songs song 
broken: broken 
turning: turning 
tag: tags 
always: always 
tonight: tonight 
ireland: ireland 
tony: tony 
hudson: hudson 
state: state 
slay: slay 
happy: happy 
header: headers 
portuguese: portuguese 
press: press 
bass: bass 
holding: holdings 
week: week 
thing: things 
northern: northern 
contemporary: contemporary 
moving: moving 
read: read 
privacy: privacy 
minute: minute 
insight: insight 
z: z 
like: like 
job: jobs 
phonographic: phonographic 
affection: affection 
answer: answer 
alternative: alternative 
go: go 
turkish: turkish 
yuki: yuki 
question: question 
rabenold: rabenold 
vending: vending 
rowe: rowe 
line: lines 
bottle: bottle 
high: high 
visit: visit 
gonna: gonna 
synthesizer: synthesizer 
debuted: debuted 
individual: individual 
espa: espa 
contact: contact 
message: message 
bella: bella 
comment: comments comment 
light: lights 
easy: easy 
grace: grace 
llc: llc 
date: date 
shop: shop 
map: map 
bridge: bridge 
format: format 
scared: scared 
valley: valley 
biding: biding 
aaron: aaron 
said: said 
drop: drop 
farsi: farsi 
vault: vault 
music: music 
winter: winter 
add: add 
growing: growing 
eviri: eviri 
ml: ml 
ice: ice 
pop: pop 
holy: holy 
acoustic: acoustic 
v: v 
e: e 
wonder: wonder 
neeko: neeko 
mastering: mastering 
novelty: novelty 
different: different 
clarice: clarice 
mention: mentions 
berg: berg 
deutsch: deutsch 
fun: fun 
starlight: starlight 
label: label 
vocal: vocal 
u: us u 
well: well 
november: november 
knew: knew 
songwriter: songwriter 
chorus: chorus 
blame: blame 
changed: changed 
information: information 
expand: expand 
republic: republic 
soaring: soaring 
want: want 
forum: forum 
trouble: trouble 
cupid: cupid 
serbian: serbian 
pond: pond 
moment: moment 
young: young 
copyright: copyright 
sample: samples 
inspired: inspired 
long: long 
stay: stay 
ol: ol 
meet: meet 
feat: feat 
fran: fran 
h: h 
mitchell: mitchell 
kind: kind 
middle: middle 
breaking: breaking 
written: written 
german: german 
policy: policy 
case: case 
n: n 
folk: folk 
release: release 
kyle: kyle 
ever: ever 
l: l 
home: home 
sign: sign 
ending: ending 
artist: artists 
cryin: cryin 
ft: ft 
collection: collection 
babe: babe 
p: p 
back: back 
traducci: traducci 
machine: machine 
way: way 
verse: verse 
taylor: taylor 
sky: sky 
nue: nue 
licensing: licensing 
share: share 
transcriber: transcribers 
actually: actually 
alongside: alongside 
prod: prod 
distinguish: distinguish 
ronan: ronan 
listening: listening 
cover: covers 
view: view 
reveals: reveals 
sad: sad 
everything: everything 
x: x 
repeating: repeating 
guide: guide 
else: else 
annotation: annotation 
yung: yung 
term: terms 
lyric: lyric lyrics 
version: version 
adult: adult 
featuring: featuring 
look: looks 
got: got 
check: check 
kitty: kitty 
really: really 
piano: piano 
tragic: tragic 
fact: facts 
personal: personal 
say: say 
italic: italics 
fever: fever 
singer: singer 
man: man 
ground: ground 
mixing: mixing 
rorp: rorp 
cry: cry 
j: j 
sigh: sigh 
use: use 
spanish: spanish 
section: section 
miss: miss 
criticize: criticize 
later: later 
commercially: commercially 
prevod: prevod 
time: time 
treacherous: treacherous 
merrill: merrill 
video: videos 
interpolate: interpolate 
developer: developers 
tired: tired 
love: love 
person: person 
feel: feel 
hot: hot 
nothing: nothing 
roll: roll 
engineer: engineer 
lord: lord 
run: run 
drive: drive 
released: released 
also: also 
ask: ask 
recorded: recorded 
peach: peaches 
eighteen: eighteen 
red: red 
musical: musical 
traducciones: traducciones 
dj: dj 
jonathan: jonathan 
twenty: twenty 
prevodi: prevodi 
k: k 
cello: cello 
