q: q 
top: topses top 
fine: fine 
number: number 
created: created 
world: world 
ruby: ruby 
olinos: olinos 
hit: hit 
swagger: swagger 
phone: phone 
wine: wine 
rescue: rescue 
liv: liv 
search: search 
barker: barker 
moriondo: moriondo 
likely: likely 
g: g 
vocalist: vocalists 
light: light 
lip: lips 
sincere: sincere 
might: might 
r: r 
beefsteak: beefsteaks 
kiss: kiss 
chose: chose 
contributor: contributor contributors 
mine: mine 
lost: lost 
genius: genius 
america: america 
understand: understand 
caused: caused 
see: see 
foaming: foaming 
even: even 
morning: morning 
cellular: cellular 
c: c 
instead: instead 
ev: ev 
credit: credits 
similarity: similarities 
second: second 
scholar: scholars 
type: type 
chart: charts 
swimmer: swimmer 
source: source 
referred: referred 
learn: learn 
gone: gone 
chloe: chloe 
foot: feet foot 
campfire: campfire 
missed: missed 
lady: ladies 
sell: sell 
oh: oh 
one: one 
kase: kase 
ob: ob 
etc: etc 
revealed: revealed 
embed: embed 
featured: featured 
eleanora: eleanora 
fate: fate 
completes: completes 
change: changes 
guideline: guidelines 
niner: niner 
miner: miners miner 
country: country 
tell: tell 
evident: evident 
shoring: shoring 
river: river 
b: b 
rush: rush 
box: boxes 
w: w 
forever: forever 
much: much 
biggest: biggest 
knowledge: knowledge 
traditional: traditional 
parody: parody 
excavating: excavating 
bold: bold 
melody: melody 
twin: twin 
herb: herb 
claim: claim 
cancel: cancel 
become: become 
verified: verified 
darling: darling 
advertise: advertise 
blowing: blowing 
warning: warning 
part: parts part 
century: century 
saying: saying 
sorry: sorry 
f: f 
transcription: transcription 
come: come 
bubble: bubbles 
gib: gib 
little: little 
promote: promote 
brine: brine 
sherman: sherman 
canyon: canyon 
jan: jan 
bounty: bounty 
two: two 
dwelt: dwelt 
ultimate: ultimate 
duckling: ducklings 
ballad: ballad 
year: year 
song: songs song 
broken: broken 
turning: turning 
cher: cher 
tag: tags 
daughter: daughter 
always: always 
dean: dean 
sauce: sauce 
called: called 
killer: killer 
believed: believed 
became: became 
maiden: maiden 
header: headers 
montrose: montrose 
dreadful: dreadful 
press: press 
holding: holdings 
drowns: drowns 
shoe: shoes 
th: th 
read: read 
privacy: privacy 
without: without 
minstrel: minstrel 
insight: insight 
california: california 
luscious: luscious 
z: z 
tongue: tongue 
like: like 
job: jobs 
answer: answer 
foster: foster 
riding: riding 
question: question 
line: lines 
trip: trips 
visit: visit 
cheek: cheek 
individual: individual 
contact: contact 
comment: comments comment 
llc: llc 
date: date 
shop: shop 
format: format 
west: west 
soft: soft 
popular: popular 
old: old 
men: men 
drop: drop 
smoke: smoke 
music: music 
add: add 
water: water 
ml: ml 
death: death 
v: v 
wool: wool 
e: e 
gold: gold 
drowned: drowned 
true: true 
different: different 
westlife: westlife 
original: original 
mention: mentions 
attribute: attribute 
toe: toe 
u: us u 
pinchers: pinchers 
tomato: tomato 
chorus: chorus 
changed: changed 
information: information 
fairy: fairy 
expand: expand 
conde: conde 
cavern: cavern 
percy: percy 
forum: forum 
cupid: cupid 
young: young 
sample: samples sample 
copyright: copyright 
take: take 
fall: falls 
h: h 
tone: tone 
written: written 
susanna: susanna 
policy: policy 
n: n 
folk: folk 
release: release 
l: l 
herring: herring 
piece: piece 
sister: sister 
sign: sign 
western: western 
forgot: forgot 
romance: romance 
timber: timber 
story: story 
size: size 
artist: artists 
thompson: thompson 
others: others 
ft: ft 
collection: collection 
generally: generally 
p: p 
clementine: clementine 
fell: fell 
slave: slave 
rye: rye 
american: american 
verse: verse 
licensing: licensing 
speech: speech 
share: share 
transcriber: transcribers 
nine: nine 
silly: silly 
kingfisher: kingfisher 
lloyd: lloyd 
example: example 
distinguish: distinguish 
close: close 
cover: covers 
view: view 
commonly: commonly 
x: x 
ala: alas 
del: del 
repeating: repeating 
guide: guide 
annotation: annotation 
er: er 
big: big 
wear: wears 
bradford: bradford 
jagger: jagger 
term: terms 
lyric: lyric lyrics 
version: version 
check: check 
moonlight: moonlight 
fact: facts 
personal: personal 
credited: credited 
italic: italics 
stephen: stephen 
singer: singer 
writer: writers 
j: j 
appear: appear 
backyardigans: backyardigans 
dey: dey 
mexican: mexican 
use: use 
spanish: spanish 
section: section 
later: later 
time: time 
dipp: dipp 
video: videos 
interpolate: interpolate 
developer: developers 
splinter: splinter 
love: love 
forgets: forgets 
lament: lament 
appears: appears 
hot: hot 
loss: loss 
drove: drove 
based: based 
ni: ni 
progress: progresses 
wet: wet 
wedder: wedder 
pale: pale 
ry: ry 
also: also 
ask: ask 
kissed: kissed 
peach: peaches 
covering: covering 
cashmere: cashmere 
sandal: sandals 
musical: musical 
goatess: goatess 
started: started 
forty: forty 
transformation: transformation 
twenty: twenty 
k: k 
de: de 
