q: q 
think: think 
favorite: favorite 
created: created 
world: world 
guitar: guitar 
know: know 
bieber: bieber 
phone: phone 
rescue: rescue 
andrew: andrew 
search: search 
nuptials: nuptials 
upcoming: upcoming 
could: could 
malcolm: malcolm 
title: title 
kidz: kidz 
g: g 
nashville: nashville 
vocalist: vocalists 
wanna: wanna 
might: might 
according: according 
spend: spend 
r: r 
bear: bear 
contributor: contributor contributors 
poo: poo 
expanded: expanded 
blacktop: blacktop 
drunk: drunk 
set: set 
billboard: billboard 
genius: genius 
understand: understand 
new: new 
confirmation: confirmation 
christmas: christmas 
josh: josh 
even: even 
polish: polish 
success: success 
present: present 
universal: universal 
girl: girls 
c: c 
credit: credits 
gladwell: gladwell 
rest: rest 
scholar: scholars 
eleven: eleven 
record: records 
monolyth: monolyth 
name: name 
ooh: ooh 
posted: posted 
umaczenie: umaczenie 
secret: secret 
scooter: scooter 
apple: apple 
type: type 
grateful: grateful 
chart: charts 
ten: ten 
translation: translation translations 
source: source 
received: received 
learn: learn 
learning: learning 
album: album 
warner: warner 
honesty: honesty 
someone: someone 
sell: sell 
oh: oh 
sapphire: sapphire 
serf: serves 
etc: etc 
embed: embed 
recording: recording recordings 
taken: taken 
rk: rk 
featured: featured 
good: good 
guideline: guidelines 
hour: hours 
heart: heart 
gotta: gotta 
first: first 
falling: falling 
track: track 
background: background 
country: country 
tell: tell 
place: places 
b: b 
dillon: dillon 
kook: kook 
w: w 
forever: forever 
south: south 
biggest: biggest 
knowledge: knowledge 
would: would 
day: days 
bold: bold 
step: step 
bryan: bryan 
twin: twin 
something: something 
shotgun: shotgun 
cancel: cancel 
verified: verified 
pre: pre 
hailey: hailey 
advertise: advertise 
titled: titled 
prior: prior 
part: parts part 
justin: justin 
whiskey: whiskey 
jordan: jordan 
jung: jung 
producer: producer 
eye: eyes 
ditty: ditty 
cure: cure 
bow: bow 
thousand: thousand 
along: along 
coinciding: coinciding 
transcription: transcription 
f: f 
programmer: programmer 
rain: rain 
never: never 
little: little 
produced: produced 
promote: promote 
art: art 
def: def 
throughout: throughout 
resonator: resonator 
ultimate: ultimate 
smile: smile 
al: al 
ballad: ballad 
artist: artist artists 
song: songs song 
broken: broken 
tag: tags 
via: via 
always: always 
tonight: tonight 
polskie: polskie 
alex: alex 
relationship: relationship 
teased: teased 
state: state 
link: link 
renowned: renowned 
header: headers 
press: press 
bass: bass 
holding: holdings 
dirty: dirty 
figure: figure 
electric: electric 
contemporary: contemporary 
th: th 
read: read 
jeff: jeff 
privacy: privacy 
kinfolk: kinfolks 
without: without 
insight: insight 
z: z 
like: like 
job: jobs 
plan: plans 
phonographic: phonographic 
mooney: mooney 
answer: answer 
turkish: turkish 
question: question 
line: lines 
propelled: propelled 
uk: uk 
visit: visit 
gonna: gonna 
synthesizer: synthesizer 
make: make 
try: try 
individual: individual 
espa: espa 
contact: contact 
comment: comments comment 
merry: merry 
easy: easy 
llc: llc 
date: date 
shop: shop 
united: united 
curiosity: curiosity 
road: road 
bridge: bridge 
sampson: sampson 
believe: believe 
format: format 
heel: heels 
relate: relate 
itswolfplayz: itswolfplayz 
said: said 
drop: drop 
music: music 
remix: remix 
add: add 
water: water 
significant: significant 
eviri: eviri 
ml: ml 
pop: pop 
reynolds: reynolds 
acoustic: acoustic 
social: socials social 
v: v 
abby: abby 
e: e 
nu: nu 
wonpil: wonpil 
get: get 
jo: jo 
additional: additional 
september: september 
mastering: mastering 
different: different 
primary: primary 
rumor: rumors 
grandma: grandma 
client: clients 
label: label 
vocal: vocals vocal 
u: us u 
well: well 
songwriter: songwriter 
retweeted: retweeted 
chorus: chorus 
jam: jam 
information: information 
head: head 
expand: expand 
shay: shay 
right: right 
take: takes 
want: want wants 
forum: forum 
cupid: cupid 
copyright: copyright 
young: young 
sample: samples 
traxx: traxx 
yeah: yeah 
ol: ol 
wmna: wmna 
manager: manager 
braun: braun 
care: care 
h: h 
somebody: somebody 
middle: middle 
written: written 
led: led 
foot: foot 
policy: policy 
case: case 
done: done 
n: n 
save: save 
release: release 
l: l 
sign: sign 
award: awards 
bop: bop 
fall: fall 
ft: ft 
collection: collection 
admirer: admirer 
p: p 
mendelson: mendelson 
traducci: traducci 
umaczenia: umaczenia 
canada: canada 
tea: tea 
verse: verse 
roadtrip: roadtrip 
carolina: carolina 
licensing: licensing 
seek: seeks 
share: share 
transcriber: transcribers 
distributor: distributor 
quickly: quickly 
trying: trying 
erg: erg 
distinguish: distinguish 
emotional: emotional 
close: close 
kid: kids 
listening: listening 
cover: covers cover 
hold: hold 
view: view 
everything: everything 
came: came 
x: x 
grew: grew 
balding: balding 
teaser: teaser 
repeating: repeating 
guide: guide 
annotation: annotation 
big: big 
show: show 
term: terms 
friend: friends 
lyric: lyric lyrics 
version: version 
adult: adult 
party: party 
dreamin: dreamin 
featuring: featuring 
look: looks 
check: check 
really: really 
piano: piano 
fact: facts 
personal: personal 
say: say 
italic: italics 
singer: singer 
wanting: wanting 
dan: dan 
mixing: mixing 
duet: duet 
j: j 
juliano: juliano 
use: use 
spanish: spanish 
jessie: jessie 
dedication: dedication 
section: section 
miss: miss 
single: single 
skill: skill 
group: group 
time: time 
video: videos 
interpolate: interpolate 
developer: developers 
love: love 
marriage: marriage 
posting: posting 
gudwin: gudwin 
hot: hot 
medium: media 
life: life 
engineer: engineer 
earworm: earworm 
hanging: hanging 
released: released 
also: also 
smyers: smyers 
ask: ask 
peach: peaches 
sweet: sweet 
master: master 
sutton: sutton 
beanpole: beanpole 
proclamation: proclamation 
bad: bad 
aydan: aydan 
remixes: remixes 
musical: musical 
dance: dance 
october: october 
traducciones: traducciones 
dj: dj 
tweet: tweet 
k: k 
polski: polski 
living: living 
truly: truly 
