sleeve: sleeve 
q: q 
covered: covered 
perform: perform 
created: created 
world: world 
guitar: guitar 
jensen: jensen 
know: know 
phone: phone 
rescue: rescue 
tennis: tennis 
con: con 
babylon: babylon 
search: search 
fling: fling 
brasil: brasil 
resnick: resnick 
could: could 
rich: rich 
ai: aises ais 
sweetest: sweetest 
marcus: marcus 
bersetzung: bersetzung 
g: g 
december: december 
vocalist: vocalists 
wanna: wanna 
lip: lips 
frequent: frequent 
might: might 
r: r 
srpski: srpski 
contributor: contributor contributors 
magyar: magyar 
cowboy: cowboy 
dessner: dessner 
coney: coney 
billboard: billboard 
genius: genius 
understand: understand 
swift: swift 
chat: chat 
romanian: romanian 
josh: josh 
traduceri: traduceri 
even: even 
refrain: refrain 
aise: aise 
c: c 
crime: crime 
credit: credits 
scholar: scholars 
gradually: gradually 
hustling: hustling 
umaczenie: umaczenie 
traduction: traduction 
live: live 
type: type 
cat: cat 
chart: charts 
marjorie: marjorie 
violin: violin 
translation: translation translations 
source: source 
learn: learn 
numata: numata 
closet: closets 
locked: locked 
dancin: dancin 
album: album 
perched: perched 
tent: tent 
ivy: ivy 
percussion: percussion 
traduzione: traduzione 
hang: hang 
someone: someone 
lady: ladies 
keyboard: keyboards 
sell: sell 
oh: oh 
one: one 
deutsche: deutsche 
low: low 
etc: etc 
embed: embed 
recording: recording 
son: sons 
baynton: baynton 
rk: rk 
featured: featured 
beautiful: beautiful 
hrvatski: hrvatski 
good: good 
guideline: guidelines 
harmonica: harmonica 
resort: resorts 
rom: rom 
studio: studio 
track: track 
background: background 
country: country 
tell: tell tells 
build: builds 
b: b 
rush: rush 
romantic: romantic 
w: w 
forever: forever 
damn: damn 
biggest: biggest 
knowledge: knowledge 
day: days 
bold: bold 
game: game 
kaufman: kaufman 
twin: twin 
shared: shared 
cancel: cancel 
verified: verified 
advertise: advertise 
robin: robin 
sung: sung 
part: parts part 
justin: justin 
eye: eyes 
calbi: calbi 
portugu: portugu 
town: town 
bersetzungen: bersetzungen 
traducere: traducere 
beneficiary: beneficiaries 
f: f 
transcription: transcription 
e: es e 
never: never 
hungarian: hungarian 
traductions: traductions 
produced: produced 
score: score 
promote: promote 
thought: thought 
mouse: mouse 
instrumentation: instrumentation 
throughout: throughout 
two: two 
closure: closure 
ultimate: ultimate 
court: court 
vernon: vernon 
al: al 
ballad: ballad 
song: songs song 
broken: broken 
fallone: fallone 
reminiscent: reminiscent 
car: car 
tag: tags 
early: early 
always: always 
polskie: polskie 
header: headers 
bed: bed 
portuguese: portuguese 
press: press 
bass: bass 
holding: holdings 
italiane: italiane 
thing: things thing 
th: th 
read: read 
privacy: privacy 
asked: asked 
insight: insight 
z: z 
like: like 
job: jobs 
blue: blues 
italian: italian 
island: island 
answer: answer 
alternative: alternative 
trick: tricks 
swindled: swindled 
turkish: turkish 
yuki: yuki 
question: question 
line: lines 
steve: steve 
ninth: ninth 
visit: visit 
gonna: gonna 
wanted: wanted 
synthesizer: synthesizer 
debuted: debuted 
individual: individual 
espa: espa 
contact: contact 
comment: comments comment 
llc: llc 
ukrainian: ukrainian 
date: date 
shop: shop 
tellin: tellin 
bridge: bridge 
believe: believe 
tradu: tradu 
format: format 
old: old 
aaron: aaron 
men: men 
said: said 
drop: drop 
swindler: swindlers 
music: music 
highest: highest 
add: add 
lead: lead 
eviri: eviri 
ml: ml 
plotted: plotted 
pop: pop 
acoustic: acoustic 
v: v 
provides: provides 
mastering: mastering 
gold: gold 
different: different 
champagne: champagne 
ti: tis 
clarice: clarice 
star: stars 
deutsch: deutsch 
thirteenth: thirteenth 
story: stories story 
vocal: vocals vocal 
charting: charting 
u: us u 
songwriter: songwriter 
backing: backing 
happiness: happiness 
chorus: chorus 
information: information 
expand: expand 
take: takes 
fuck: fuck 
forum: forum 
folk: folks folk 
serbian: serbian 
cupid: cupid 
beneath: beneath 
mandolin: mandolin 
copyright: copyright 
sample: samples 
personnel: personnel 
fancy: fancy 
forward: forward 
ol: ol 
meet: meet 
traduzioni: traduzioni 
skeleton: skeletons 
fran: fran 
h: h 
body: body 
written: written 
german: german 
hard: hard 
policy: policy 
n: n 
video: video videos 
release: release 
l: l 
evermore: evermore 
sok: sok 
tolerate: tolerate 
sign: sign 
fall: fall 
artist: artists 
season: season 
collection: collection 
p: p 
consistent: consistent 
mumford: mumford 
traducci: traducci 
machine: machine 
way: way 
umaczenia: umaczenia 
verse: verse 
taylor: taylor 
licensing: licensing 
share: share 
transcriber: transcribers 
distributor: distributor 
willow: willow 
airport: airport 
trying: trying 
ong: ong 
lunchin: lunchin 
problem: problems 
distinguish: distinguish 
view: view 
arrangement: arrangement 
french: french 
x: x 
drum: drums drum 
repeating: repeating 
guide: guide 
annotation: annotation 
coale: coale 
italiana: italiana 
big: big 
dorothea: dorothea 
term: terms 
dark: dark 
lyric: lyric lyrics 
version: version 
featuring: featuring 
got: got 
check: check 
really: really 
hear: hear 
piano: piano 
logan: logan 
fact: facts 
personal: personal 
italic: italics 
greg: greg 
boot: boots 
waiting: waiting 
singer: singer 
mixing: mixing 
full: full 
j: j 
italiano: italiano 
fan: fan 
use: use 
spanish: spanish 
section: section 
bar: bar 
youtube: youtube 
passed: passed 
collaborator: collaborator 
garden: gardens 
aesthetic: aesthetic 
prevod: prevod 
developer: developers 
love: love 
sitting: sitting 
hot: hot 
outro: outro 
ford: ford 
life: life 
engineer: engineer 
hanging: hanging 
also: also 
rock: rock 
em: em 
hustlin: hustlin 
short: short 
ask: ask 
peach: peaches 
musical: musical 
dangerous: dangerous 
dance: dance 
bandit: bandit 
traducciones: traducciones 
jonathan: jonathan 
prevodi: prevodi 
k: k 
polski: polski 
anything: anything 
cello: cello 
pay: pay 
