feeling: feelings 
touching: touching 
q: q 
griffith: griffith 
change: change 
favorite: favorite 
created: created 
together: together 
world: world 
guitar: guitar 
know: know 
word: words 
judge: judge 
passion: passion 
tom: tom 
jeanne: jeanne 
front: front 
brasil: brasil 
color: colors 
could: could 
sterling: sterling 
already: already 
title: title 
g: g 
deehousemf: deehousemf 
interpolation: interpolations 
vocalist: vocalists 
knowing: knowing 
certification: certifications 
might: might 
riaa: riaa 
r: r 
best: best 
morrison: morrison 
contributor: contributor contributors 
street: street 
morton: morton 
digital: digital 
lia: lia 
genius: genius 
memorizing: memorizing 
understand: understand 
swift: swift 
see: see 
new: new 
gallo: gallo 
end: end 
even: even 
driving: driving 
c: c 
begin: begin 
storyteller: storytellers 
crime: crime 
frog: frog 
suddenly: suddenly 
credit: credits 
scholar: scholars 
getting: getting 
wish: wish 
gray: gray 
record: records 
almost: almost 
still: still 
felt: felt 
live: live 
type: type 
bukovac: bukovac 
chart: charts 
lose: lose 
translation: translation translations 
source: source 
received: received 
last: last 
learn: learn 
album: album 
maddie: maddie 
campbell: campbell 
percussion: percussion 
sell: sell 
oh: oh 
one: one 
emulation: emulation 
mc: mc 
flying: flying 
assistant: assistant 
wind: wind 
etc: etc 
embed: embed 
recording: recording 
missing: missing 
blue: blue 
featured: featured 
beautiful: beautiful 
regretting: regretting 
guideline: guidelines 
breakdown: breakdown 
gotta: gotta 
paul: paul 
livy: livy 
track: track 
mash: mash 
country: country 
tell: tell 
itzy: itzy 
b: b 
losing: losing 
realizing: realizing 
w: w 
ilya: ilya 
biggest: biggest 
knowledge: knowledge 
wilson: wilson 
duduzinho: duduzinho 
sloas: sloas 
bold: bold 
need: need 
huff: huff 
organ: organ 
twin: twin 
cancel: cancel 
verified: verified 
advertise: advertise 
vida: vida 
vh: vh 
part: parts part 
justin: justin 
bit: bit 
echo: echoes 
impossible: impossible 
daring: daring 
toshinskiy: toshinskiy 
viva: viva 
portugu: portugu 
drew: drew 
strong: strong 
hank: hank 
f: f 
transcription: transcription 
e: es e 
come: come comes 
never: never 
free: free 
produced: produced 
promote: promote 
chapman: chapman 
franklin: franklin 
call: call 
cimorelli: cimorelli 
marcantonio: marcantonio 
spectrum: spectrum 
met: met 
two: two 
lucky: lucky 
ultimate: ultimate 
al: al 
year: year 
song: songs song 
side: side 
broken: broken 
anthem: anthem 
tag: tags 
always: always 
fifth: fifth 
production: production 
since: since 
alex: alex 
medley: medley 
fighting: fighting 
relationship: relationship relationships 
believed: believed 
state: state 
deluxe: deluxe 
header: headers 
portuguese: portuguese 
press: press 
bass: bass 
holding: holdings 
originally: originally 
mike: mike 
sag: sag 
moving: moving 
read: read 
passionate: passionate 
privacy: privacy 
insight: insight 
alexi: alexi 
z: z 
like: like 
job: jobs 
platinum: platinum 
affection: affection 
answer: answer 
go: go 
performance: performances 
question: question 
whoa: whoa 
burning: burning 
line: lines 
bright: bright 
steve: steve 
dann: dann 
studio: studios 
milik: milik 
visit: visit 
wanted: wanted 
synthesizer: synthesizer 
jason: jason 
lee: lee 
alone: alone 
individual: individual 
thing: thing 
espa: espa 
contact: contact 
message: message 
comment: comments comment 
light: lights 
easy: easy 
grace: grace 
llc: llc 
date: date 
shop: shop 
televised: televised 
williams: williams 
bridge: bridge 
tradu: tradu 
format: format 
forgetting: forgetting 
bouzouki: bouzouki 
certified: certified 
old: old 
steel: steel 
crossword: crossword 
aaron: aaron 
said: said 
drop: drop 
nicole: nicole 
music: music 
spinning: spinning 
add: add 
thinking: thinking 
emotion: emotions 
editing: editing 
flashback: flashbacks 
jake: jake 
nathan: nathan 
ml: ml 
pop: pop 
found: found 
holy: holy 
acoustic: acoustic 
hidden: hidden 
v: v 
loop: loop 
current: current 
space: space 
mastering: mastering 
actor: actor 
different: different 
niebank: niebank 
original: original 
starlight: starlight 
jimmie: jimmie 
label: label 
cause: cause 
u: us u 
interpreted: interpreted 
well: well 
knew: knew 
songwriter: songwriter 
zodiac: zodiac 
chorus: chorus 
changed: changed 
information: information 
head: head 
expand: expand 
right: right 
emma: emma 
dead: dead 
forum: forum 
trouble: trouble 
cupid: cupid 
moment: moment 
copyright: copyright 
sample: samples sample 
yeah: yeah 
round: round 
stay: stay 
ol: ol 
maserati: maserati 
worst: worst 
la: la 
ana: ana 
h: h 
somebody: somebody 
written: written 
possible: possible 
compare: compares 
policy: policy 
n: n 
wishing: wishing 
goot: goot 
release: release 
writing: writing 
ever: ever 
l: l 
home: home 
sign: sign 
sagittarius: sagittarius 
gyllenhaal: gyllenhaal 
girl: girl 
fall: fall 
ending: ending 
artist: artists 
ft: ft 
collection: collection 
generally: generally 
p: p 
correlating: correlating 
bollman: bollman 
back: back 
traducci: traducci 
machine: machine 
post: post 
verse: verse 
taylor: taylor 
alpine: alpine 
licensing: licensing 
share: share 
transcriber: transcribers 
trying: trying 
coordinator: coordinator 
upright: upright 
distinguish: distinguish 
cover: covers cover 
view: view 
jealousy: jealousy 
french: french 
sad: sad 
everything: everything 
x: x 
drum: drums 
repeating: repeating 
guide: guide 
annotation: annotation 
big: big 
frustration: frustration 
harmony: harmony 
term: terms 
dark: dark 
solve: solve 
lyric: lyric lyrics 
version: version 
check: check 
throwback: throwback 
demo: demo 
piano: piano 
pro: pro 
tragic: tragic 
fact: facts 
personal: personal 
promotional: promotional 
italic: italics 
skateboard: skateboard 
singer: singer 
went: went 
ground: ground 
mixing: mixing 
david: david 
j: j 
arcade: arcade 
use: use 
spanish: spanish 
section: section 
seth: seth 
single: single 
faster: faster 
later: later 
anger: anger 
time: time 
treacherous: treacherous 
video: videos 
interpolate: interpolate 
developer: developers 
charlie: charlie 
remembering: remembering 
inspiration: inspiration 
love: love 
great: great 
official: official 
hot: hot 
mind: mind 
yudkin: yudkin 
outro: outro 
loving: loving 
engineer: engineer 
released: released 
also: also 
rock: rock 
autumn: autumn 
em: em 
ask: ask 
blackbird: blackbird 
recorded: recorded 
peach: peaches 
red: red 
musical: musical 
let: let 
october: october 
traducciones: traducciones 
sin: sin 
jonathan: jonathan 
known: known 
ganjo: ganjo 
k: k 
