guideline: guidelines 
u: u us 
debuting: debuting 
apologetix: apologetix 
la: la 
woman: woman women 
k: k 
leaf: leaves 
road: road 
might: might 
contributor: contributor contributors 
interpolate: interpolate 
cupid: cupid 
baby: baby 
climbin: climbin 
featured: featured 
even: even 
comment: comment comments 
lookin: lookin 
world: world 
seventy: seventies 
transcriber: transcribers 
created: created 
sound: sound 
say: say says 
hey: hey 
part: parts part 
understand: understand 
band: band 
read: read 
first: first 
n: n 
opening: opening 
ask: ask 
bernie: bernie 
also: also 
stone: stone 
maybe: maybe 
lyric: lyric lyrics 
slowin: slowin 
become: become 
background: background 
fine: fine 
witchy: witchy 
j: j 
morning: morning 
mckinney: mckinney 
songwriter: songwriter 
globelamp: globelamp 
wanna: wanna 
artist: artists 
single: single 
drum: drums 
drop: drop 
vida: vida 
track: track 
know: know 
performance: performances 
country: country 
zaccheus: zaccheus 
embed: embed 
holding: holdings 
viva: viva 
transcription: transcription 
running: running 
travis: travis 
job: jobs 
gil: gil 
load: load 
lemonheads: lemonheads 
rescue: rescue 
loosen: loosen 
learn: learn 
engineer: engineer 
date: date 
credit: credits 
lose: lose 
lyin: lyin 
h: h 
chorus: chorus 
q: q 
album: album albums 
musical: musical 
debut: debut 
c: c 
label: label 
v: v 
insight: insight 
wheel: wheels 
guide: guide 
still: still 
hall: hall 
famously: famously 
release: release 
later: later 
bass: bass 
flatbed: flatbed 
frey: frey 
crazy: crazy 
record: records 
advertise: advertise 
personal: personal 
version: version 
oh: oh 
twin: twin 
different: different 
billboard: billboard 
source: source 
summer: summer 
musician: musician 
jason: jason 
f: f 
friend: friend 
promote: promote 
fame: fame 
peaceful: peaceful 
scholar: scholars 
forum: forum 
nightingale: nightingale 
classic: classic 
type: type 
included: included 
june: june 
devil: devil 
winslow: winslow 
term: terms 
solo: solo 
tryin: tryin 
corey: corey 
chug: chug 
distinguish: distinguish 
although: although 
make: make 
copyright: copyright 
r: r 
outro: outro 
e: e 
july: july 
knowledge: knowledge 
arizona: arizona 
gonna: gonna 
john: johns 
lighten: lighten 
signature: signature 
verified: verified 
policy: policy 
share: share 
verse: verse 
etc: etc 
visit: visit 
individual: individual 
sell: sell 
g: g 
peach: peaches 
line: lines 
sad: sad 
never: never 
phonographic: phonographic 
love: love 
rock: rock 
two: two 
ultimate: ultimate 
l: l 
search: search 
randy: randy 
may: may 
trying: trying 
ft: ft 
drive: drive 
trouble: trouble 
earlybird: earlybird 
soft: soft 
use: use 
try: try 
cover: cover covers 
got: got 
expand: expand 
fact: facts 
song: songs song 
vocalist: vocalists 
take: take 
mann: manns 
listening: listening 
lord: lord 
jackson: jackson 
look: look 
question: question 
feeling: feeling 
live: live 
meisner: meisner 
like: like 
sample: samples 
licensing: licensing 
spending: spending 
broken: broken 
developer: developers 
written: written 
glenn: glenn 
taylor: taylor 
music: music 
tag: tags 
browne: browne 
slide: slide 
contact: contact 
singer: singer 
lead: lead 
place: place 
everyman: everyman 
z: z 
open: open 
genius: genius 
guitar: guitar 
b: b 
tritt: tritt 
chart: chart charts 
recorded: recorded 
glyn: glyn 
mind: mind 
standing: standing 
repeating: repeating 
mine: mine 
collection: collection 
press: press 
southern: southern 
x: x 
always: always 
sight: sight 
sweet: sweet 
seven: seven 
bold: bold 
train: train 
acoustic: acoustic 
studio: studios 
well: well 
view: view 
stand: stand 
hot: hot 
yacht: yacht 
oughta: oughta 
shaped: shaped 
compilation: compilation 
ford: ford 
second: second 
one: one 
vocal: vocals 
shop: shop 
biggest: biggest 
w: w 
eagle: eagles 
girl: girl 
week: weeks 
privacy: privacy 
gotta: gotta 
singing: singing 
annotation: annotation 
roll: roll 
italic: italics 
four: four 
released: released 
eye: eyes 
win: win 
night: night 
cancel: cancel 
produced: produced 
llc: llc 
banjo: banjo 
video: videos 
p: p 
easy: easy 
blow: blow 
london: london 
find: find 
henley: henley 
add: add 
check: check 
sign: sign 
though: though 
come: come 
format: format 
olympic: olympic 
section: section 
hard: hard 
pop: pop 
let: let 
ml: ml 
save: save 
corner: corner 
lover: lover 
header: headers 
leadon: leadon 
peaked: peaked 
see: see 
information: information 
asylum: asylum 
