camila: camila 
go: go goes 
extends: extends 
interpolate: interpolate 
gutman: gutman 
vertalingen: vertalingen 
following: following 
created: created 
transcriber: transcribers 
sisk: sisk 
end: ends end 
tree: tree 
death: death 
spotify: spotify 
revealed: revealed 
tiny: tiny 
japanese: japanese 
razavi: razavi 
concept: concept 
shopping: shopping 
see: sees 
rom: rom 
engineer: engineer 
date: date 
traducciones: traducciones 
calm: calm 
q: q 
lady: ladies lady 
mixing: mixing 
third: third 
god: god 
v: v 
recording: recording 
later: later 
release: release 
interviewer: interviewer 
portugu: portugu 
want: want wants 
street: street 
personal: personal 
twin: twin 
spanish: spanish 
leave: leave 
joe: joe 
swear: swear 
home: home 
bersetzung: bersetzung 
record: record records 
received: received 
type: type 
unveiled: unveiled 
asked: asked 
feature: features 
keyboard: keyboards 
session: sessions 
reached: reached 
share: share shares 
traductions: traductions 
making: making 
g: g 
line: lines 
directly: directly 
vocal: vocal 
love: love 
haze: haze 
two: two 
urban: urban 
cover: cover covers 
strictly: strictly 
expand: expand 
got: got 
campaign: campaign 
relationship: relationship 
get: get 
e: es e 
tag: tags 
americana: americana 
place: place 
z: z 
house: house 
known: known 
ups: ups 
miss: miss 
remixes: remixes 
modern: modern 
overdramatic: overdramatic 
always: always 
globe: globe 
mtv: mtv 
brasil: brasil 
forgot: forgot 
illustrating: illustrating 
bold: bold 
atv: atv 
niall: niall 
view: view 
sony: sony 
aise: aise 
moonlight: moonlight 
biggest: biggest 
privacy: privacy 
italic: italics 
u: us u 
amas: amas 
ai: ais aises 
light: lights 
pop: pop 
table: table 
originated: originated 
save: save 
header: headers 
information: information 
immediately: immediately 
espa: espa 
nederland: nederlands 
guideline: guidelines 
attended: attended 
bridge: bridges bridge 
dermot: dermot 
kirsch: kirsch 
man: man 
contributor: contributor contributors 
erban: erban 
even: even 
flashing: flashing 
part: parts part 
understand: understand 
read: read 
first: first 
vespodd: vespodd 
w: w 
also: also 
christmas: christmas 
ever: ever 
ilomilo: ilomilo 
day: day days 
deutsch: deutsch 
songwriter: songwriter 
dancing: dancing 
programmer: programmer 
italiana: italiana 
em: em 
bell: bell 
track: track 
hand: hand 
performance: performances performance 
country: country 
scar: scar 
radio: radio 
publishing: publishing 
traducere: traducere 
songwritery: songwritery 
string: string 
pair: pair 
credit: credits 
percussion: percussion 
chorus: chorus 
musical: musical 
vogue: vogue 
choice: choice 
insight: insight 
bass: bass 
chris: chris 
take: takes take 
heartbreak: heartbreak 
billboard: billboard 
number: number 
source: source 
summer: summer summers 
suspicious: suspicious 
livestream: livestream 
friend: friend friends 
certification: certifications 
prevodi: prevodi 
highly: highly 
adult: adult 
september: september 
mysterious: mysterious 
term: terms 
ghenea: ghenea 
romanian: romanian 
uk: uk 
farsi: farsi 
polskie: polskie 
copyright: copyright 
r: r 
snow: snow 
knowledge: knowledge 
megan: megan 
down: downs 
verified: verified 
visit: visit 
nice: nice 
sell: sell 
savannah: savannah 
rule: rules 
dear: dear 
occasion: occasions 
l: l 
search: search 
mash: mash 
heart: heart 
new: new 
second: seconds 
traduceri: traduceri 
dawn: dawn 
sample: samples 
developer: developers 
taylor: taylor 
york: york 
bersetzungen: bersetzungen 
think: think 
al: al 
french: french 
kennedy: kennedy 
ball: ball 
press: press 
boy: boy 
studio: studios 
well: well 
single: singles single 
iheartradio: iheartradio 
srpski: srpski 
beanie: beanie 
partner: partner 
shop: shop 
format: format 
gentleman: gentlemen 
section: section 
thousand: thousand 
ml: ml 
target: target 
forever: forever 
jingle: jingle 
progress: progress 
honey: honey 
bri: bri 
ah: ah 
world: world 
appeared: appeared 
title: title 
living: living 
ol: ol 
npr: npr 
n: n 
uke: uke 
lyric: lyric lyrics 
th: th 
desk: desk 
j: j 
described: described 
artist: artists artist 
portuguese: portuguese 
january: january 
fran: fran 
til: til 
shoegaze: shoegaze 
inspiration: inspiration 
polish: polish 
gala: gala 
wop: wop 
von: von 
twenty: twenty 
fm: fm 
embed: embed 
romeo: romeo 
holding: holdings 
transcription: transcription 
job: jobs 
doo: doo 
bbc: bbc 
answer: answer 
learn: learn 
mendes: mendes 
burrow: burrows 
female: female 
album: album 
enchanced: enchanced 
label: label 
need: need 
twitter: twitter 
dirtiest: dirtiest 
version: version 
advertise: advertise 
oh: oh 
know: knows 
call: call 
italiane: italiane 
f: f 
traduction: traduction 
itunes: itunes 
make: make 
dedicated: dedicated 
cornelia: cornelia 
borrowed: borrowed 
assistant: assistant 
daylight: daylight 
individual: individual 
capital: capital 
republic: republic 
phonographic: phonographic 
able: able 
ultimate: ultimate 
director: director 
song: songs song 
teased: teased 
performed: performed 
live: live 
licensing: licensing 
could: could 
american: american 
music: music 
contact: contact 
laura: laura 
along: along 
serbian: serbian 
round: round 
medium: media 
prod: prod 
guitar: guitar 
paper: paper 
fletcher: fletcher 
collection: collection 
alleged: alleged 
concert: concert 
prior: prior 
remix: remix 
tradu: tradu 
false: false 
keith: keith 
italiano: italiano 
stand: stand 
force: force 
hot: hot 
exclusive: exclusive 
traduzioni: traduzioni 
seat: seat 
right: rights 
said: said 
umaczenia: umaczenia 
one: one 
aug: aug 
nederlandse: nederlandse 
video: video videos 
annotation: annotation 
released: released 
traducci: traducci 
p: p 
alwyn: alwyn 
eleven: eleven 
edition: edition 
dazzling: dazzling 
add: add 
check: check 
antonoff: antonoff 
sign: sign 
come: come 
favorite: favorite 
history: history 
let: let 
k: k 
frank: frank 
might: might 
interest: interest 
cupid: cupid 
speech: speech 
halsey: halsey 
featured: featured 
comment: comment comments 
swift: swift 
say: say 
told: told 
afterglow: afterglow 
ask: ask 
youtube: youtube 
ballad: ballad 
yes: yes 
true: true 
joke: jokes 
darling: darling 
tara: tara 
wedding: wedding 
decade: decade 
mall: mall 
drop: drop 
room: room 
horan: horan 
entertainment: entertainment 
blue: blue 
bmi: bmi 
rescue: rescue 
romance: romance 
bosanski: bosanski 
h: h 
composed: composed 
three: three 
c: c 
better: better 
cut: cuts 
way: way 
guide: guide 
translation: translation translations 
announced: announced 
user: user 
electric: electric 
haunting: haunting 
stuck: stuck 
different: different 
producer: producer 
prince: prince 
perspective: perspective 
august: august 
publisher: publisher 
loved: loved 
german: german 
umaczenie: umaczenie 
original: original 
promote: promote 
scholar: scholars 
secret: secret 
forum: forum 
sapphire: sapphire 
distinguish: distinguish 
nugget: nugget 
rooney: rooney 
story: story 
drew: drew 
policy: policy 
verse: verse 
etc: etc 
peach: peaches 
teen: teen 
waltzy: waltzy 
hanes: hanes 
several: several 
instrumentation: instrumentation 
ft: ft 
traduzione: traduzione 
inside: inside 
behind: behind 
use: use 
romantic: romantic 
fact: facts 
revealing: revealing 
dance: dance 
vocalist: vocalists 
question: question 
usa: usa 
like: like 
jack: jack 
broken: broken 
acceptance: acceptance 
ring: rings 
written: written 
existed: existed 
soon: soon 
polski: polski 
singer: singer 
genius: genius 
b: b 
italian: italian 
recorded: recorded 
city: city 
repeating: repeating 
year: years 
prevod: prevod 
time: time 
x: x 
magnetic: magnetic 
piano: piano 
cabello: cabello 
chart: charts 
shawn: shawn 
crash: crash 
every: every 
everyone: everyone 
night: night 
please: please 
cancel: cancel 
produced: produced 
paris: paris 
llc: llc 
vertaling: vertaling 
london: london 
saturday: saturday 
john: john 
cruel: cruel 
deutsche: deutsche 
really: really 
archer: archer 
milestone: milestone 
lover: lover 
award: awards 
close: close 
lounge: lounge 
contemporary: contemporary 
