go: go 
wish: wishes 
interpolation: interpolations 
created: created 
transcriber: transcribers 
sisk: sisk 
folk: folk 
tiny: tiny 
ya: ya 
ukrainian: ukrainian 
side: side 
rom: rom 
engineer: engineer 
date: date 
traducciones: traducciones 
mixing: mixing 
q: q 
v: v 
recording: recording 
release: release 
portugu: portugu 
anything: anything 
personal: personal 
twin: twin 
spanish: spanish 
home: home 
bersetzung: bersetzung 
type: type 
tupelo: tupelo 
skippin: skippin 
james: james 
keyboard: keyboards 
share: share 
traductions: traductions 
g: g 
line: lines 
never: never 
mom: mom 
pageant: pageant 
love: love 
josh: josh 
tell: tell 
happiness: happiness 
synthesizer: synthesizer 
got: got 
expand: expand 
eviri: eviri 
ong: ong 
e: es e 
scheme: schemes 
tag: tags 
americana: americana 
place: place 
z: z 
known: known 
ti: tis 
mind: mind 
season: season 
bates: bates 
always: always 
brasil: brasil 
calmer: calmer 
bold: bold 
view: view 
problem: problems 
ivy: ivy 
aise: aise 
biggest: biggest 
holiday: holidays 
privacy: privacy 
kaufman: kaufman 
italic: italics 
u: us u 
ai: ais aises 
pop: pop 
header: headers 
information: information 
espa: espa 
guideline: guidelines 
willow: willow 
shined: shined 
distributor: distributor 
contributor: contributor contributors 
stop: stop 
even: even 
part: parts part 
understand: understand 
read: read 
first: first 
w: w 
also: also 
ever: ever 
deutsch: deutsch 
soul: soul 
songwriter: songwriter 
wanna: wanna 
italiana: italiana 
drum: drums 
em: em 
eighth: eighth 
teddy: teddy 
track: track 
know: know 
country: country 
traducere: traducere 
body: body 
credit: credits 
percussion: percussion 
chorus: chorus 
musical: musical 
piss: piss 
insight: insight 
bass: bass 
island: island 
source: source 
direct: direct 
champagne: champagne 
prevodi: prevodi 
adult: adult 
term: terms 
romanian: romanian 
polskie: polskie 
r: r 
copyright: copyright 
outro: outro 
knowledge: knowledge 
verified: verified 
uh: uh 
visit: visit 
sell: sell 
woo: woo 
inez: inez 
storyline: storyline 
hometown: hometown 
low: low 
l: l 
search: search 
soft: soft 
school: school 
mastering: mastering 
traduceri: traduceri 
sample: samples 
character: character 
greg: greg 
developer: developers 
taylor: taylor 
cowboy: cowboy 
bersetzungen: bersetzungen 
think: think 
tolerate: tolerate 
al: al 
french: french 
press: press 
dessner: dessner 
turkish: turkish 
well: well 
december: december 
srpski: srpski 
shop: shop 
gold: gold 
fallone: fallone 
eye: eyes 
nothin: nothin 
format: format 
titular: titular 
section: section 
closure: closure 
ml: ml 
back: back 
honey: honey 
rk: rk 
hollywood: hollywood 
ah: ah 
post: post 
aaron: aaron 
world: world 
crime: crime 
ol: ol 
n: n 
lyric: lyric lyrics 
show: show 
brighter: brighter 
j: j 
clarified: clarified 
artist: artists 
portuguese: portuguese 
fran: fran 
prom: prom 
embed: embed 
holding: holdings 
transcription: transcription 
job: jobs 
doveman: doveman 
magyar: magyar 
answer: answer 
learn: learn 
national: national 
album: album 
left: left 
benjamin: benjamin 
narrative: narrative 
makeup: makeup 
evermore: evermore 
version: version 
advertise: advertise 
italiane: italiane 
f: f 
traduction: traduction 
personnel: personnel 
damn: damn 
individual: individual 
ultimate: ultimate 
queen: queen 
return: return 
song: songs song 
bein: bein 
licensing: licensing 
american: american 
give: give 
music: music 
contact: contact 
laura: laura 
late: late 
guitar: guitar 
misery: misery 
collection: collection 
tradu: tradu 
italiano: italiano 
marjorie: marjorie 
hot: hot 
traduzioni: traduzioni 
ford: ford 
umaczenia: umaczenia 
bleacher: bleachers 
old: old 
betty: betty 
annotation: annotation 
lark: lark 
traducci: traducci 
video: videos 
guess: guess 
p: p 
chase: chase 
add: add 
check: check 
sign: sign 
come: come 
coney: coney 
small: small 
dorathea: dorathea 
since: since 
makin: makin 
k: k 
point: point 
might: might 
cupid: cupid 
featured: featured 
comment: comment comments 
swift: swift 
hey: hey 
told: told 
ask: ask 
dorothea: dorothea 
ballad: ballad 
referred: referred 
sok: sok 
met: met 
drop: drop 
sellin: sellin 
wrote: wrote 
alternative: alternative 
rescue: rescue 
h: h 
ooh: ooh 
c: c 
way: way 
guide: guide 
still: still 
translation: translation translations 
short: short 
different: different 
tired: tired 
august: august 
german: german 
umaczenie: umaczenie 
promote: promote 
scholar: scholars 
forum: forum 
park: park 
lanz: lanz 
distinguish: distinguish 
steve: steve 
story: story 
policy: policy 
verse: verse 
etc: etc 
peach: peaches 
rush: rush 
rock: rock 
screen: screen 
dream: dreams 
traduzione: traduzione 
use: use 
studio: studio 
fact: facts 
vocalist: vocalists 
question: question 
like: like 
broken: broken 
younger: younger 
magazine: magazines 
written: written 
shiny: shiny 
polski: polski 
singer: singer 
genius: genius 
b: b 
italian: italian 
repeating: repeating 
prevod: prevod 
seems: seems 
friend: friends 
x: x 
buy: buy 
piano: piano 
pre: pre 
went: went 
continuation: continuation 
chart: charts 
likely: likely 
girl: girl 
jonathan: jonathan 
cancel: cancel 
produced: produced 
llc: llc 
deutsche: deutsche 
town: town 
star: stars 
tambourine: tambourine 
lover: lover 
contemporary: contemporary 
see: see 
calbi: calbi 
