go: go 
mark: mark 
interpolate: interpolate 
conniff: conniff 
square: square 
rogers: rogers 
pato: pato 
created: created 
transcriber: transcribers 
witchcraft: witchcraft 
chamberlain: chamberlain 
lifted: lifted 
johnny: johnny 
haggard: haggard 
ch: ch 
pappalardo: pappalardo 
cop: cop 
california: california 
hollyridge: hollyridge 
manilow: manilow 
chloe: chloe 
colorful: colorful 
king: king 
date: date 
melody: melody 
q: q 
oelhrich: oelhrich 
v: v 
brother: brothers 
master: master 
release: release 
bastard: bastard 
want: want 
personal: personal 
twin: twin twins 
stuart: stuart 
movie: movies 
richard: richard 
mick: mick 
peter: peter 
type: type 
sinatra: sinatra 
bennett: bennett 
donnell: donnell 
james: james 
sutcliffe: sutcliffe 
kobalt: kobalt 
mouskouri: mouskouri 
share: share 
sledge: sledge 
g: g 
belong: belong 
line: lines 
never: never 
fu: fu 
moriondo: moriondo 
love: love 
life: life 
tell: tell 
cover: cover covers 
expand: expand 
boyzone: boyzone 
katie: katie 
demis: demis 
tag: tags 
z: z 
known: known 
jasmin: jasmin 
raides: raides 
pausini: pausini 
mine: mine 
came: came 
always: always 
authentic: authentic 
sweet: sweet 
bold: bold 
streisand: streisand 
view: view 
die: die 
daniel: daniel 
francis: francis 
floyd: floyd 
biggest: biggest 
robbins: robbins 
privacy: privacy 
italic: italics 
u: us u 
ken: ken 
happy: happy 
aura: aura 
voice: voice 
rough: rough 
golden: golden 
header: headers 
information: information 
madison: madison 
guideline: guidelines 
marty: marty 
contributor: contributor contributors 
raleigh: raleigh 
even: even 
cramer: cramer 
tinder: tinder 
roussos: roussos 
part: parts part 
understand: understand 
read: read 
first: first 
w: w 
also: also 
platter: platters 
gott: gott 
lee: lee 
songwriter: songwriter 
kenny: kenny 
xp: xp 
teddy: teddy 
track: track 
garden: garden 
performance: performances performance 
country: country 
wing: wing 
whittaker: whittaker 
gambatese: gambatese 
hyland: hyland 
brand: brands 
nolesto: nolesto 
swallow: swallows 
credit: credits 
arteta: arteta 
chorus: chorus 
brown: brown browns 
musical: musical 
insight: insight 
bocelli: bocelli 
end: end 
heartbreak: heartbreak 
source: source 
control: control 
long: long 
shout: shout 
ronstadt: ronstadt 
civil: civil 
september: september 
term: terms 
veloso: veloso 
karel: karel 
r: r 
copyright: copyright 
snow: snow 
knowledge: knowledge 
vera: vera 
verified: verified 
rodriguez: rodriguez 
visit: visit 
nice: nice 
sell: sell 
dear: dear 
l: l 
search: search 
complete: complete 
amy: amy 
heart: heart 
david: david 
jackson: jackson 
barbra: barbra 
sample: samples 
developer: developers 
andrea: andrea 
group: group 
sunshine: sunshine 
ainhoa: ainhoa 
press: press 
adriano: adriano 
linda: linda 
project: project 
studio: studios 
acoustic: acoustic 
wanda: wanda 
string: strings 
engelbert: engelbert 
shop: shop 
poulton: poulton 
dolcemente: dolcemente 
air: air 
adam: adam 
stereo: stereo 
format: format 
section: section 
remembered: remembered 
ml: ml 
titled: titled 
los: los 
world: world 
ol: ol 
n: n 
reno: reno 
lyric: lyric lyrics 
rca: rca 
th: th 
j: j 
macarons: macarons 
ronson: ronson 
artist: artists 
til: til 
elvis: elvis 
dog: dog 
maid: maid 
embed: embed 
holding: holdings 
transcription: transcription 
job: jobs 
price: price 
learn: learn 
shook: shook 
colvin: colvin 
jailhouse: jailhouse 
caetano: caetano 
label: label 
ray: ray 
need: need 
mina: mina 
record: records 
hair: hair 
version: version 
advertise: advertise 
blooded: blooded 
f: f 
gregorian: gregorian 
connie: connie 
lyrical: lyrical 
barry: barry 
jenn: jenn 
e: e 
nogar: nogar 
norah: norah 
individual: individual 
darby: darby 
ultimate: ultimate 
fred: fred 
song: songs song 
george: george 
prozz: prozz 
take: take 
live: live 
licensing: licensing 
begin: begin 
music: music 
contact: contact 
laura: laura 
along: along 
hasselhoff: hasselhoff 
melua: melua 
hallyday: hallyday 
collection: collection 
negative: negative 
hot: hot 
victor: victor 
right: rights 
annotation: annotation 
retro: retro 
percy: percy 
video: videos 
p: p 
made: made 
edition: edition 
add: add 
check: check 
english: english 
sign: sign 
rider: riders 
let: let 
war: war 
k: k 
dirty: dirty 
frank: frank 
might: might 
humperdinck: humperdinck 
cupid: cupid 
havran: havran 
featured: featured 
comment: comment comments 
much: much 
mollin: mollin 
matson: matson 
heartache: heartaches 
ask: ask 
ballad: ballad 
true: true 
darling: darling 
angeles: angeles 
vanished: vanished 
bear: bear 
drop: drop 
roger: roger 
levy: levy 
nelson: nelson 
tony: tony 
brian: brian 
bmi: bmi 
nk: nk 
rescue: rescue 
clayderman: clayderman 
h: h 
loving: loving 
theme: theme 
c: c 
originally: originally 
guide: guide 
way: way 
hall: hall 
william: william 
different: different 
hotel: hotel 
publisher: publisher 
promote: promote 
exceptionally: exceptionally 
scholar: scholars 
forum: forum 
fulfilled: fulfilled 
hound: hound 
presley: presley 
distinguish: distinguish 
thorne: thorne 
steve: steve 
grant: grant 
frill: frills 
policy: policy 
tender: tender 
toten: toten 
verse: verse 
etc: etc 
peach: peaches 
rock: rock 
hosen: hosen 
ft: ft 
dream: dreams 
use: use 
fox: fox 
te: tes 
fact: facts 
vocalist: vocalists 
jones: jones 
question: question 
mclean: mclean 
like: like 
thee: thee 
broken: broken 
treat: treat 
written: written 
singer: singer 
genius: genius 
b: b 
willie: willie 
recorded: recorded 
repeating: repeating 
year: years 
time: time 
x: x 
ernie: ernie 
cold: cold 
nana: nana 
merle: merle 
nat: nat 
cliff: cliff 
chart: charts 
shawn: shawn 
cancel: cancel 
produced: produced 
llc: llc 
cruel: cruel 
cole: cole 
enterprise: enterprises 
instrumental: instrumental 
jane: jane 
century: century 
lea: lea 
word: words 
